Alien vs. Predator|Alien Vs Predator|Alien vs Predator|Alien vs Predator|
Alpine Games|||Alpine Games|
APB: All Points Bulletin|APB - All Points Bulletin|A.P.B. - All Points Bulletin|All Points Bulletin|
Awesome Golf|Awesome Golf|Awesome Golf|Awesome Golf|
Baseball Heroes|Baseball Heroes|Baseball Heroes|Baseball Heroes|
Basketbrawl|Basketbrawl|Basketbrawl|Basketbrawl|
Batman Returns|Batman Returns|Batman Returns|Batman Returns|
BattleWheels|Battle Wheels|Battle Wheels|Battle Wheels|
Battlezone 2000|Battlezone 2000|Battlezone 2000|Battlezone 2000|
Bill & Ted's Excellent Adventure|Bill & Ted's Excellent Adventure|Bill & Ted's Excellent Adventure|Bill & Ted's Excellent Adventure|
Blockout|Block Out|Block Out|Block Out|
Blue Lightning|Blue Lightning|Blue Lightning|Blue Lightning|
Bubble Trouble|Bubble Trouble|Bubble Trouble|Bubble Trouble|
California Games|California Games|California Games|California Games|
Centipede|Centipede|Centipede|Centipede|
Checkered Flag|Checkered Flag|Checkered Flag|Checkered Flag|
Chip's Challenge|Chip's Challenge|Chip's Challenge|Chip's Challenge|
Crystal Mines II: Buried Treasure|||Crystal Mines II - Buried Treasure|
Crystal Mines II|Crystal Mines II|Crystal Mines II|Crystal Mines II|
Daemonsgate||Daemonsgate||
Desert Strike: Return to the Gulf|Desert Strike - Return to the Gulf|Desert Strike - Return to the Gulf|Desert Strike - Return to the Gulf|
Dinolympics|Dinolympics|Dinolympics|Dinolympics|
Dirty Larry: Renegade Cop|Dirty Larry - Renegade Cop|Dirty Larry - Renegade Cop|Dirty Larry - Renegade Cop|
Double Dragon|Double Dragon|Double Dragon|Double Dragon|
Dracula the Undead|Dracula - The Undead|Dracula the Undead|Dracula - The Undead|
Electrocop|Electrocop|Electrocop|Electrocop|
European Soccer Challenge|European Soccer Challenge|European Soccer Challenge|European Soccer Challenge|
Eye of the Beholder|Eye of the Beholder|Eye of the Beholder|Eye of the Beholder|
Fat Bobby|Fat Bobby|Fat Bobby|Fat Bobby|
Gauntlet: The Third Encounter|Gauntlet - The Third Encounter|Gauntlet - The Third Encounter|Gauntlet - The Third Encounter|
Gordo 106: The Mutated Lab Monkey|Gordo 106 - The Mutated Lab Monkey|Gordo 106 - The Mutated Lab Monkey|Gordo 106 - The Mutated Lab Monkey|
Hard Drivin'|Hard Drivin'|Hard Drivin'|Hard Drivin'|
Hockey|Hockey|Hockey|Hockey|
Hydra|Hydra|Hydra|Hydra|
Ishido: The Way of Stones|Ishido - The Way of the Stones|Ishido - The Way of Stones|Ishido - The Way of the Stones|
Jimmy Connors Pro Tennis Tour|Jimmy Conners Tennis|Jimmy Connors' Tennis|Jimmy Connors Tennis|
Joust|Joust|Joust|Joust|
Klax|Klax|Klax|Klax|
Krazy Ace Miniature Golf|Krazy Ace Minature Golf|Krazy Ace - Miniature Golf|Krazy Ace Minature Golf|
Kung Food|Kung Food|Kung Food|Kung Food|
Lemmings|Lemmings|Lemmings|Lemmings|
Lexis|Lexis|Lexis|Lexis|
Loopz|Loopz|Loopz|Loopz |
Lynx Casino|Lynx Casino|Lynx Casino|Lynx Casino|
Lynx Othello|||Lynx Othello|
Malibu Bikini Volleyball|Malibu Bikini Volleyball|Malibu Bikini Volleyball|Malibu Bikini Volleyball|
Marlboro Go!|Marlboro Go!|Marlboro Go!|Marlboro Go!|
Ms. Pac-Man|Ms. Pac-Man|Ms. Pac-Man|Ms. Pac-Man|
Name|GoodName|NoIntro|TOSEC|ReDump
NFL Football|NFL Football|NFL Football|NFL Football|
Ninja Gaiden III: The Ancient Ship of Doom|Ninja Gaiden III - The Ancient Ship of Doom|Ninja Gaiden III - The Ancient Ship of Doom|Ninja Gaiden III - Ancient Ship of Doom|
Ninja Gaiden|Ninja Gaiden|Ninja Gaiden|Ninja Gaiden|
Pac-Land|Pac-Land|Pac-Land|Pac-Land|
Paperboy|Paperboy|Paperboy|Paperboy|
Pinball Jam|Pinball Jam|Pinball Jam|Pinball Jam|
Pit-Fighter|Pit Fighter - The Ultimate Competition|Pit Fighter - The Ultimate Competition|Pit Fighter|
Poker Mania|||PokerMania|
Ponx|||Ponx|
Power Factor|Power Factor|Power Factor|Power Factor|
Prophecy 1: The Viking Child|Viking Child|Viking Child|Viking Child|
QIX|Qix|Qix|Qix|
Raiden|Raiden|Raiden|Raiden|
Rampage|Rampage|Rampage|Rampage|
Rampart|Rampart|Rampart|Rampart|
RoadBlasters|RoadBlasters|RoadBlasters|Road Blasters|
Road Riot 4WD|Road Riot 4WD|Road Riot 4WD|Road Riot|
Robo-Squash|Robo-Squash|Robo-Squash|Robo Squash|
Robotron 2084|Robotron 2084|Robotron 2084|Robotron 2084|
Rygar|Rygar - Legendary Warrior|Rygar - Legendary Warrior|Rygar - Legendary Warrior|
Scrapyard Dog|Scrapyard Dog|Scrapyard Dog|Scrapyard Dog|
Shadow of the Beast|Shadow of the Beast|Shadow of the Beast|Shadow of the Beast|
Shanghai|Shanghai|Shanghai|Shanghai|
S.I.M.I.S.|||S.I.M.I.S.|
SokoMania|||SokoMania|
Steel Talons|Steel Talons|Steel Talons|Steel Talons|
S.T.U.N. Runner|S.T.U.N. Runner|S.T.U.N. Runner|S.T.U.N. Runner|
Super Asteroids and Missile Command|Super Asteroids & Missile Command|Super Asteroids, Missile Command|Super Asteroids & Missile Command|
Super Off Road|Super Off-Road|Super Off-Road||
Super Skweek|Super Skweek|Super Skweek|Super Skweek|
Switchblade II|Switchblade II|Switchblade II|Switchblade II|
The Fidelity Ultimate Chess Challenge|Fidelity Ultimate Chess Challenge|Fidelity Ultimate Chess Challenge, The|Fidelity Ultimate Chess Challenge|
The Gates of Zendocon|Gates of Zendocon, The|Gates of Zendocon, The|Gates of Zendocon, The|
Todd's Adventures in Slime World|Todd's Adventure in Slime World|Todd's Adventures in Slime World|Todd's Adventures - Slime World|
Toki: Going Ape Spit|Toki|Toki|Toki|
Tournament Cyberball 2072|Tournament Cyberball 2072|Tournament Cyberball 2072|Tournament Cyberball 2072|
T-Tris|T-Tris (1996) by Bastian Schick||T-Tris|
Turbo Sub|Turbo Sub|Turbo Sub|Turbo Sub|
Warbirds|Warbirds|Warbirds|Warbirds|
World Class Soccer|World Class Soccer|World Class Soccer|World Class Soccer|
Xenophobe|Xenophobe|Xenophobe|Xenophobe|
Xybots|Xybots|Xybots|Xybots|
Zarlor Mercenary|Zarlor Mercenary|Zarlor Mercenary|Zarlor Mercenary|
