2 Shot Diary 2 4-4|2 Shot Diary 2 4-4|||
2 Shot Diary|2 Shot Diary|||
31 Iwayuruhitotsu no Chou Lovery na Boken Katsugeki|31 Iwayuruhitotsu no Chou Lovery na Boken Katsugeki|||
3x3 Eyes|3x3 Eyes|||
5x5 Go! Go!|5x5 Go! Go!|||
Aa Megamisama|Aa Megamisama|||
Absolutely Mahjongg|Absolutely Mahjongg|||
Abunai Bunkasai|Abunai Bunkasai|||
Ace of Spades|Ace of Spades|||
AD&D: Curse of the Azure Bonds|AD&D - Curse of the Azure Bonds|||
AD&D: Pools of Darkness|AD&D - Pools of Darkness|||
AD&D: Secret of the Silver Blades|AD&D - Secret of the Silver Blades|||
Advanced Power Dolls 2|Advanced Power Dolls 2|||
Ah! An|Ah! An|||
Air Duel|Air Duel|||
Ai Shimai: Futari no Kazitsu|Ai Shimai - Futari no Kazitsu|||
Akatsuki no Bizanteira|Akatsuki no Bizanteira|||
Akatsuki no Bizenteira|Akatsuki no Bizenteira|||
Akemi|Akemi|||
Akihime: Goddess in the Caeseress|Akihime - Goddess in the Caeseress|||
Akumu: Aoi Kajitsu no Sanka|Akumu - Aoi Kajitsu no Sanka|||
Alantia|Alantia|||
Alaskan Malamute G.C.|Alaskan Malamute G.C.|||
Alice no Yakata 2|Alice no Yakata 2|||
Alice no Yakata 3|Alice no Yakata 3|||
Alone in the Dark|Alone in the Dark|||
Amaranth|Amaranth|||
Amaranth III|Amaranth III|||
Amaranth IV|Amaranth IV|||
Amaranth KH|Amaranth KH|||
Ambivalenz|Ambivalenz|||
Amida ChonChon|Amida ChonChon|||
Ami to Yobanaide!|Ami to Yobanaide!|||
Angel|Angel|||
Angel Halo|Angel Halo|||
Angel Hearts|Angel Hearts|||
Angel Night: Yamiyowo Kakeru Tenshitachi no Monogatari|Angel Night - Yamiyowo Kakeru Tenshitachi no Monogatari|||
Angelus|Angelus|||
Anime Mahjong X|Anime Mahjong X|||
Ankoku Sennen Oukoku|Ankoku Sennen Oukoku|||
Anniversary: Natsuyasumi no Omoide|Anniversary - Natsuyasumi no Omoide|||
Aokiookami to Shirokimezika Genchohishi|Aokiookami to Shirokimezika Genchohishi|||
Arabesque!|Arabesque!|||
Arcus 3|Arcus 3|||
Armist|Armist|||
Armored Girl Nirvana Mai|Armored Girl Nirvana Mai|||
Armor Girl|Armor Girl|||
Arquelphos|Arquelphos|||
Arrow Gunner EX|Arrow Gunner EX|||
Artemis|Artemis|||
Astro Wars Part II Revival|Astro Wars Part II Revival|||
Ayasi|Ayasi|||
Ayayo 3|Ayayo 3|||
Backlash of Feed|Backlash of Feed|||
Bacta 2|Bacta 2|||
Balance of Power|Balance of Power|||
Ballade for Maria|Ballade for Maria|||
Battle Block Alfin|Battle Block Alfin|||
Battle Queen: Saikiyoo Fighters Retuden|Battle Queen - Saikiyoo Fighters Retuden|||
Beast Breeders|Beast Breeders|||
Beast III|Beast III|||
Beat Vice|Beat Vice|||
Bell's Avenue Vol. 1|Bell's Avenue Vol. 1|||
Beyond: Kurotaisyo ni Mirareteru|Beyond - Kurotaisyo ni Mirareteru|||
Birthdays|Birthdays|||
Block Out|Block Out|||
Block Wars V|Block Wars V|||
Blood Seed|Blood Seed|||
Blue Garnet|Blue Garnet|||
Bomber Quest|Bomber Quest|||
Boxer Maker|Boxer Maker|||
Brandish VT|Brandish VT|||Brandish VT
Branmarker|Branmarker|||
Bretonne Lays|Bretonne Lays|||
Brocken|Brocken|||
Bunkasai|Bunkasai|||
Bunretsu Shiyugo Shin Twinkle Star|Bunretsu Shiyugo Shin Twinkle Star|||
Burai Jokan|Burai Jokan|||
Byakuya Monogatari|Byakuya Monogatari|||
Cal 2|Cal 2|||
Cal|Cal|||
Calcutta|Calcutta|||
Canaan: Kannou Kyoushuu|Canaan - Kannou Kyoushuu|||
Can Can Bunny 2|Can Can Bunny 2|||
Can Can Bunny 3|Can Can Bunny 3|||
Can Can Bunny 4: Premiere|Can Can Bunny 4 - Premiere|||
Can Can Bunny 5 12 Limited|Can Can Bunny 5 12 Limited|||
Can Can Bunny 5 Extra|Can Can Bunny 5 Extra|||
Can Can Bunny|Can Can Bunny|||
Caramel Quest|Caramel Quest|||
Carat|Carat|||
Card Force|Card Force|||
Car II: Grand Prix|Car II - Grand Prix|||
Cats Part 1|Cats Part 1|||
C.G. Gallery 7: Escort|C.G. Gallery 7 - Escort|||
CG Gallery Vol. 1|CG Gallery Vol. 1|||
Chakura|Chakura|||
Chaos Angels|Chaos Angels|||
Charade|Charade|||
Cherry Bomb|Cherry Bomb|||
Cherry Moderate|Cherry Moderate|||
Chick's Tale|Chick's Tale|||
ChingHai|ChingHai|||
Chitty Chitty Train|Chitty Chitty Train|||
Chookooso Crisis|Chookooso Crisis|||
Chou Bangai Seifuku Zukan Plus|Chou Bangai Seifuku Zukan Plus|||
Christine|Christine|||
Chushiuki: Hibasawa Nurse School|Chushiuki - Hibasawa Nurse School|||
Clone Doll Kagaijyugyo|Clone Doll Kagaijyugyo|||
Coin|Coin|||
Collecter D|Collecter D|||
Collector D Bangaihen|Collector D Bangaihen|||
Collon Club 2 .2.000.000|Collon Club 2 .2.000.000|||
Colonial Conquest|Colonial Conquest|||
Columns|Columns|||
Coming Heart|Coming Heart|||
Continental|Continental|||
Crazy Labyrinth|Crazy Labyrinth|||
Creastar|Creastar|||
Crom Paradise: Ginhakushiyoku no Rakuen|Crom Paradise - Ginhakushiyoku no Rakuen|||
CRW 2|CRW 2|||
Crystal Chaser|Crystal Chaser|||
Crystal Rinal|Crystal Rinal|||
Custom Mate 2|Custom Mate 2|||
Custom Mate 3|Custom Mate 3|||
Custom Mate|Custom Mate|||
Cuty Cop|Cuty Cop|||
Cyber Illusion|Cyber Illusion|||
Cyber School 98|Cyber School 98|||
Daifugo Gakuen|Daifugo Gakuen|||
Dai Hinmin: Taiketsu Seifuku Musume|Dai Hinmin - Taiketsu Seifuku Musume|||
Daisenryaku 4|Daisenryaku 4|||
Daisenryaku 4: Option Disk|Daisenryaku 4 - Option Disk|||
Dalk|Dalk|||
Dans in Due|Dans in Due|||
Daraku no Kuni no Angie: Kyoukai no Mesudorei Tachi|Daraku no Kuni no Angie - Kyoukai no Mesudorei Tachi|||
Dark Gaiden|Dark Gaiden|||
Dead of the Brain 2|Dead of the Brain 2|||
Dead of the Brain|Dead of the Brain|||
Deep|Deep|||
Deja Vu 2|Deja Vu 2|||
Deja Vu: A Nightmare Comes True|Deja Vu - A Nightmare Comes True|||
Delfoi no Shintaku|Delfoi no Shintaku|||
Demon City|Demon City|||
Dengeki Division|Dengeki Division|||
Dengeki Nurse 2|Dengeki Nurse 2|||
Dengeki Nurse|Dengeki Nurse|||
Denno Gakuen 2|Denno Gakuen 2|||
Denno Gakuen 3|Denno Gakuen 3|||
Denno Gakuen 4|Denno Gakuen 4|||
Denno Gakuen|Denno Gakuen|||
Dennoo Senati Lavian|Dennoo Senati Lavian|||
Dessert|Dessert|||
Devil Chain|Devil Chain|||
Disaster|Disaster|||
Doki Doki Vacance|Doki Doki Vacance|||
Dokkin Minako Sensei!|Dokkin Minako Sensei!|||
Doppyundonpishya|Doppyundonpishya|||
Dor 2|Dor 2|||
Dor 3|Dor 3|||
Dor|Dor|||
Dor Special Edition 93|Dor Special Edition 93|||
Dor Special Edition Sakigake|Dor Special Edition Sakigake|||
Doukyusei|Doukyusei|||
Dracula Hakusyaku|Dracula Hakusyaku|||
Dragon Egg|Dragon Egg|||
Dragon Half|Dragon Half|||
Dragon Knight 2|Dragon Knight 2|||
Dragon Knight 4|Dragon Knight 4|||
Dragon Knight 4 Special Disk|Dragon Knight 4 Special Disk|||
Dragon Knight|Dragon Knight|||
Dragon Knight III|Dragon Knight III|||
Dragon Pink|Dragon Pink|||
Dragon Princess|Dragon Princess|||
Dragonslayer Eiyu Densetsu 4|Dragonslayer Eiyu Densetsu 4|||
Dragon Strike|Dragon Strike|||
Dragoon Armor for Adult|Dragoon Armor for Adult|||
DS98 #10|DS98 #10|||
DS98 #11|DS98 #11|||
DS98 #12|DS98 #12|||
DS98 #13|DS98 #13|||
DS98 #14|DS98 #14|||
DS98 #15|DS98 #15|||
DS98 #16|DS98 #16|||
DS98 #17|DS98 #17|||
DS98 #18|DS98 #18|||
DS98 #9|DS98 #9|||
D. Wars|D. Wars|||
Dynamo|Dynamo|||
Echigoya|Echigoya|||
Eden no Kaori|Eden no Kaori|||
Edge|Edge|||
Elemental O|Elemental O|||
Elest|Elest|||
Elle|Elle|||
Elm Knight|Elm Knight|||
Elvira: Mistress of the Dark|Elvira - Mistress of the Dark|||
Emerald Dragon|Emerald Dragon|||
Enchanter|Enchanter|||
Enemy of Humans|Enemy of Humans|||
Engage Errands 2|Engage Errands 2|||
Engage Errands|Engage Errands|||
Entax|Entax|||
Entfuhrer|Entfuhrer|||
Erika|Erika|||
Escalation 95|Escalation 95|||
Escape|Escape|||
Es no Houteishiki|Es no Houteishiki|||
E.S.P.|E.S.P.|||
Etemible|Etemible|||
Etsuraku no Gakuen|Etsuraku no Gakuen|||
Eturaku no Okita: Aoi Taiken|Eturaku no Okita - Aoi Taiken|||
EVE Burst Error|EVE Burst Error|||
Evil Spirit of the Nurses' Office|Evil Spirit of the Nurses' Office|||
Exceed Jack|Exceed Jack|||
Eye of the Beholder III: Assault on Myth Drannor|Eye of the Beholder III - Assault on Myth Drannor|||
Faara no Jikekkai|Faara no Jikekkai|||
Fantasy Night|Fantasy Night|||
Farland Story 2|Farland Story 2|||
Farland Story 3|Farland Story 3|||
Farland Story 4|Farland Story 4|||
Farland Story 5|Farland Story 5|||
Farland Story|Farland Story|||
Fervent Nereid: She's So Unusual|Fervent Nereid - She's So Unusual|||
File 0|File 0|||
File|File|||
Flashback|Flashback|||
Flash Chase|Flash Chase|||
Flixx: Mogler 2|Flixx - Mogler 2|||
Foreigner|Foreigner|||
Foxy|Foxy|||
Fukkatusai: Asticaya no Mazyo|Fukkatusai - Asticaya no Mazyo|||
Fushigi no Umi no Nadia|Fushigi no Umi no Nadia|||
Fushigi no Umi no Nadia Option Disk|Fushigi no Umi no Nadia Option Disk|||
Gaias Lord|Gaias Lord|||
Gaina Rock 2|Gaina Rock 2|||
Gakuen Bakuretsu Tenkousei|Gakuen Bakuretsu Tenkousei|||
Gakuen Bomber|Gakuen Bomber|||
Gakuen Monogatari 93: The Instinct|Gakuen Monogatari 93 - The Instinct|||
Gakuen Monogatari|Gakuen Monogatari|||
Gakuen Senshi Sailor Fighter|Gakuen Senshi Sailor Fighter|||
Galaga|Galaga|||
Gal's Sweeper|Gal's Sweeper|||
GaoGao! 1st Radical Sequence|GaoGao! 1st Radical Sequence|||
GaoGao! 2nd Pandora Wood|GaoGao! 2nd Pandora Wood|||
Gendai Daisenryaku Ex|Gendai Daisenryaku Ex|||
Geneitoshi: Illusion City|Geneitoshi - Illusion City|||
Geo Slave|Geo Slave|||
Get!|Get!|||
Giga Mortion|Giga Mortion|||
Ginga Eiyu Densetsu 2 Dx Kit|Ginga Eiyu Densetsu 2 Dx Kit|||
Ginga Eiyu Densetsu 3|Ginga Eiyu Densetsu 3|||
Ginga Eiyu Densetsu 3 SP|Ginga Eiyu Densetsu 3 SP|||
Ginga Eiyu Densetsu 4|Ginga Eiyu Densetsu 4|||
Girl 2|Girl 2|||
Girls Paradise|Girls Paradise|||
Gloria|Gloria|||
Goice|Goice|||
Gokko Vol. 01 Doctor|Gokko Vol. 01 Doctor|||
Gokko Vol. 02 School Gal's|Gokko Vol. 02 School Gal's|||
Gokuraku Mannara|Gokuraku Mannara|||
Gozira|Gozira|||
Gram Cats|Gram Cats|||
Grand Prix Circus 2 Formula 1 World Championship|Grand Prix Circus 2 Formula 1 World Championship|||
Groundseed|Groundseed|||
Guardian Recall|Guardian Recall|||
Guernica|Guernica|||
Gunblaze|Gunblaze|||
Hamlet|Hamlet|||
Hana no Kioku|Hana no Kioku|||
Harenti Gakeun|Harenti Gakeun|||
Harlem Blade|Harlem Blade|||
Heater Powerful|Heater Powerful|||
High School War|High School War|||
Hoshinosuna Monogatari|Hoshinosuna Monogatari|||
Hotei Raoyui 2|Hotei Raoyui 2|||
Hyooryuu|Hyooryuu|||
Idol Project 2|Idol Project 2|||
If 2|If 2|||
If 3|If 3|||
If|If|||
Ikenie|Ikenie|||
Ikuiku Pakun|Ikuiku Pakun|||
Immoral Study 2|Immoral Study 2|||
Immoral Study 3|Immoral Study 3|||
Immoral Study|Immoral Study|||
Injiu Genmu 2: Brain Burst|Injiu Genmu 2 - Brain Burst|||
Injiu Genmu|Injiu Genmu|||
In the Dungeon|In the Dungeon|||
Intruder|Intruder|||
Ippatsu Jang!|Ippatsu Jang!|||
Ireen|Ireen|||
Iris Serenade|Iris Serenade|||
Irium|Irium|||
Isaku|Isaku|||
Itsuka Dokokade|Itsuka Dokokade|||
Jack: Haitoku no Megami|Jack - Haitoku no Megami|||
Jango 3|Jango 3|||
Jan Jaka Jan|Jan Jaka Jan|||
Jankenpon|Jankenpon|||
Japanese Cult Quiz Zipang|Japanese Cult Quiz Zipang|||
J.B. Harold 3: Dc Connection|J.B. Harold 3 - Dc Connection|||
Jealousy|Jealousy|||
Jewul Bem Hunter Lime|Jewul Bem Hunter Lime|||
Jiin|Jiin|||
Joker 2|Joker 2|||
Joker|Joker|||
Jonason: Kugutsu no Mai|Jonason - Kugutsu no Mai|||
Jyb|Jyb|||
Kaiketsu Nikki|Kaiketsu Nikki|||
Kakutou Musume|Kakutou Musume|||
Kakyusei|Kakyusei|||
Kakyusei Special Disk|Kakyusei Special Disk|||
Kanako|Kanako|||
Kanako-san no Yuu'utsu|Kanako-san no Yuu'utsu|||
Kankin|Kankin|||
Karei Naru Jinsei 2|Karei Naru Jinsei 2|||
Karei Naru Jinsei|Karei Naru Jinsei|||
Kawarazakike no Ichizoku|Kawarazakike no Ichizoku|||
Kekkou Kamen|Kekkou Kamen|||
Kerakera Hoshi|Kerakera Hoshi|||
Kids: SAP 2nd file|Kids - SAP 2nd file|||
Kikai Jikake no Marian|Kikai Jikake no Marian|||
Kimagure Orange Road|Kimagure Orange Road|||
Kimidakeni Aiwo|Kimidakeni Aiwo|||
Kindan no Ketsuzoku|Kindan no Ketsuzoku|||
King's Dungeon: The Story of Heroes|King's Dungeon - The Story of Heroes|||
Kirishima Sinryojio no Gogo|Kirishima Sinryojio no Gogo|||
Kisou Shinden Gen-Kaiser|Kisou Shinden Gen-Kaiser|||
Kitou Mashi Shioshi Keimeshiyo|Kitou Mashi Shioshi Keimeshiyo|||
Kohakuiro no Yuigon|Kohakuiro no Yuigon|||
Koihime: Mystic Princess|Koihime - Mystic Princess|||
Kokoha Rakuenso 2|Kokoha Rakuenso 2|||
Kokoha Rakuenso|Kokoha Rakuenso|||
Konseki: Kizuato|Konseki - Kizuato|||
Kookookioshi|Kookookioshi|||
Kotestu no Daiboken|Kotestu no Daiboken|||
Koukan Nikki 2|Koukan Nikki 2|||
Koukan Nikki|Koukan Nikki|||
Kounai Shasei 2|Kounai Shasei 2|||
Kounai Shasei 3|Kounai Shasei 3|||
Kounai Shasei|Kounai Shasei|||
Kousoku Chojin|Kousoku Chojin|||
Kurayami|Kurayami|||
Kuroneko Kan|Kuroneko Kan|||
Kuru|Kuru|||
Kurumichan Ninja|Kurumichan Ninja|||
Kusuryubi no Kyookashiyoo|Kusuryubi no Kyookashiyoo|||
Kyarukan|Kyarukan|||
Kyohaku|Kyohaku|||
Kyouiku Jiyushikoosei Maniacs|Kyouiku Jiyushikoosei Maniacs|||
Lakers 2|Lakers 2|||
Lakers|Lakers|||
Last Armageddon|Last Armageddon|||
Last Guardian 2|Last Guardian 2|||
Last Guardian|Last Guardian|||
Leading Company|Leading Company|||
Leap Tokini Sawarareta Shoujo|Leap Tokini Sawarareta Shoujo|||
Lemon Angel|Lemon Angel|||
L'Empereur|L'Empereur|||
Lenam: Sword of Legend|Lenam - Sword of Legend|||
LEX|LEX|||
Libido 7|Libido 7|||
Life and Death|Life and Death|||
Life & Death II: The Brain|Life & Death II - The Brain|||
Life is Music|Life is Music|||
Like|Like|||
Lime|Lime|||
Lipstick Adventure 2|Lipstick Adventure 2|||
Lipstick Adventure 3|Lipstick Adventure 3|||
Lipstick Adventure|Lipstick Adventure|||
Lodoss to Senki 1: Haiiro no Majio|Lodoss to Senki 1 - Haiiro no Majio|||
Lodoss to Senki 2: 5 Syoku no Majio|Lodoss to Senki 2 - 5 Syoku no Majio|||
Lodoss to Senki 3: Fukujinduke|Lodoss to Senki 3 - Fukujinduke|||
Love Phantom|Love Phantom|||
Lucky Travel|Lucky Travel|||
Lunatic Dawn 2|Lunatic Dawn 2|||
Lunatic Dawn|Lunatic Dawn|||
Macross 1: Remember Me|Macross 1 - Remember Me|||
Macross 2: Skull Leader|Macross 2 - Skull Leader|||
Macross 3: Love Stories|Macross 3 - Love Stories|||
Mad Paradox|Mad Paradox|||
Mahjong Kyo Jidai Special 2|Mahjong Kyo Jidai Special 2|||
Mahjong Sports Line|Mahjong Sports Line|||
Makyoden|Makyoden|||
Manami no Dokomade Ikuno 2|Manami no Dokomade Ikuno 2|||
Mandara Kazoku|Mandara Kazoku|||
Marginal Points|Marginal Points|||
Marine Buster|Marine Buster|||
Marine Philt|Marine Philt|||
Marines|Marines|||
Mario Bros. Special|Mario Bros. Special|||
Markadia|Markadia|||
Marple Magic|Marple Magic|||
Maryu Gakuen: Yogosareta Nikutai|Maryu Gakuen - Yogosareta Nikutai|||
Maskarade|Maskarade|||
Master Hand|Master Hand|||
Master of Monstars 2: Scenario Disk|Master of Monstars 2 - Scenario Disk|||
Master of Monstars Final: Tasogare no Yubiwa|Master of Monstars Final - Tasogare no Yubiwa|||
Master of Monsters 2|Master of Monsters 2|||
Maten Gakuen|Maten Gakuen|||
Mayumi|Mayumi|||
Meikyuu Gakuensai|Meikyuu Gakuensai|||
Mel Mel|Mel Mel|||
Melon Soda|Melon Soda|||
Memories Refrain|Memories Refrain|||
Merry Go Round|Merry Go Round|||
Mesunko Hishiyoshitsu|Mesunko Hishiyoshitsu|||
Metajo|Metajo|||
Metal Eye 2|Metal Eye 2|||
Metal Mover Jaststrike|Metal Mover Jaststrike|||
Metal Orange|Metal Orange|||
Mighty Head|Mighty Head|||
Miho Premium Collection No. 003|Miho Premium Collection No. 003|||
Minimum Gainarock|Minimum Gainarock|||
Mirage 2|Mirage 2|||
Mirage|Mirage|||
Mischif|Mischif|||
Mission|Mission|||
Misty Flash|Misty Flash|||
Mobile Suit Gundam: One Year War|Mobile Suit Gundam - One Year War|||
Mobile Suit Gundam: Return of Zion|Mobile Suit Gundam - Return of Zion|||
Mokkoriman RPG|Mokkoriman RPG|||
Momocochan|Momocochan|||
Moon Light Enegy|Moon Light Enegy|||
Moon Mist|Moon Mist|||
MS-DOS|MS-DOS|||
Mugen Hoyo|Mugen Hoyo|||
Mug-R|Mug-R|||
Mujintoo Monogatari 2|Mujintoo Monogatari 2|||
Mujintou Monogatari|Mujintou Monogatari|||
Nadia of the Sea: Mysteries of Blue Water|Nadia of the Sea - Mysteries of Blue Water|||
Name|HyperList|NoIntro|TOSEC|ReDump
Nanba Kosuke|Nanba Kosuke|||
Napple City|Napple City|||
Napple City Volume 2|Napple City Volume 2|||
Natudama|Natudama|||
Necronomicon|Necronomicon|||
Nijiiro Denshoku Musume|Nijiiro Denshoku Musume|||
Ningiyushi no Isan|Ningiyushi no Isan|||
Ningyotsukai 2|Ningyotsukai 2|||
Nobunaga no Yabo Busyo Fuunroku|Nobunaga no Yabo Busyo Fuunroku|||
Nobunaga no Yabo Haoden|Nobunaga no Yabo Haoden|||
Nobunaga no Yabo Haoden Powerup Disk|Nobunaga no Yabo Haoden Powerup Disk|||
Nobunaga no Yabo Tensyoki|Nobunaga no Yabo Tensyoki|||
Nonomura Byioin no Hitobito|Nonomura Byioin no Hitobito|||
Nooch 2: Revenge of Remy|Nooch 2 - Revenge of Remy|||
Nooch 3|Nooch 3|||
Nooch|Nooch|||
Nostalgia 1907|Nostalgia 1907|||
Nova Miirareta Sitai|Nova Miirareta Sitai|||
Nurse no Mumasensen|Nurse no Mumasensen|||
Oedo Renaissance|Oedo Renaissance|||
Oedo Tantei Kamiya Ukyou Vol. II|Oedo Tantei Kamiya Ukyou Vol. II|||
Oh! Kitsunesama|Oh! Kitsunesama|||
Ohotuku ni Kiyu|Ohotuku ni Kiyu|||
Oh! Pai|Oh! Pai|||
Okiraku Block Chobin de Run-Run|Okiraku Block Chobin de Run-Run|||
OL Sousamou|OL Sousamou|||
Onnanoko no Shikumi|Onnanoko no Shikumi|||
Oogon no Rashimban|Oogon no Rashimban|||
Panorama Club|Panorama Club|||
Paparazzo|Paparazzo|||
Para.Dice: Have You Seen the Highwayman|Para.Dice - Have You Seen the Highwayman|||
Paradise Arena|Paradise Arena|||
Persona: Ingyaku no Kamen|Persona - Ingyaku no Kamen|||
Phil Snown|Phil Snown|||
Phobos|Phobos|||
Pia Carrot he Youkoso!!: We've Been Waiting For You|Pia Carrot he Youkoso!! - We've Been Waiting For You|||
Pick Up Mahjong Master|Pick Up Mahjong Master|||
Pink Shock Pirates II|Pink Shock Pirates II|||
Pink Sox 2|Pink Sox 2|||
Pink Sox 3|Pink Sox 3|||
Pink Sox 4|Pink Sox 4|||
Pink Sox 5|Pink Sox 5|||
Pink Sox 6|Pink Sox 6|||
Pink Sox 7|Pink Sox 7|||
Pink Sox 8|Pink Sox 8|||
Pink Sox|Pink Sox|||
Pinky Ponky 2|Pinky Ponky 2|||
Pinky Ponky 3|Pinky Ponky 3|||
Pinky Ponky|Pinky Ponky|||
Ponkan|Ponkan|||
Power Dolls 2|Power Dolls 2|||
Power Dolls|Power Dolls|||
Pretty Agent|Pretty Agent|||
Pretty Mahjong Soldier Mu|Pretty Mahjong Soldier Mu|||
Pretty Soldier Sailor Moon|Pretty Soldier Sailor Moon|||
Princess Confusion|Princess Confusion|||
Princess Maker 2|Princess Maker 2|||
Princess Maker|Princess Maker|||
Princess Minerva|Princess Minerva|||
Private School Adventure|Private School Adventure|||
Private Slave|Private Slave|||
Purple Cat Vol 1|Purple Cat Vol 1|||
Purple Cat Vol 2|Purple Cat Vol 2|||
Purple Cat Vol 3|Purple Cat Vol 3|||
Puyo Puyo|Puyo Puyo|||
Queen Library|Queen Library|||
Queen's Cup|Queen's Cup|||
Quintia Road 2|Quintia Road 2|||
Quiz Bancho|Quiz Bancho|||
Quiz Chiryaku no Hasya: Sangokushi Kitan|Quiz Chiryaku no Hasya - Sangokushi Kitan|||
Quiz de Let's go!|Quiz de Let's go!|||
Quiz Tonosama no Yabo|Quiz Tonosama no Yabo|||
Quiz Zatunen Labo|Quiz Zatunen Labo|||
Rabuyuni|Rabuyuni|||
Ragnarook|Ragnarook|||
Rall 3|Rall 3|||
Rance 3 Hint Disk|Rance 3 Hint Disk|||
Rance 4|Rance 4|||
Ranma 12 Hiryu Densetu|Ranma 12 Hiryu Densetu|||
Ranma 12 Ougi Yokoshima Kura Kobushi|Ranma 12 Ougi Yokoshima Kura Kobushi|||
Ray Cards|Ray Cards|||
Record of Strange Beast War Kasutami|Record of Strange Beast War Kasutami|||
Red Cobra|Red Cobra|||
Reichsritter|Reichsritter|||
Reijiyu: Twin Road|Reijiyu - Twin Road|||
Reserve 12|Reserve 12|||
Reserve|Reserve|||
Resurrect|Resurrect|||
Review|Review|||
Rhyme Star|Rhyme Star|||
Ribbon|Ribbon|||
Ring Master 2|Ring Master 2|||
Ring Master|Ring Master|||
Ring Out|Ring Out|||
Rinkan Gakkou|Rinkan Gakkou|||
Robo Crush 2|Robo Crush 2|||
Robo Crush 98|Robo Crush 98|||
Rose|Rose|||
Rouge no Densetsu|Rouge no Densetsu|||
Round Warrior|Round Warrior|||
Run Run Concerto|Run Run Concerto|||
Ryu|Ryu|||
S.A. 2|S.A. 2|||
S.A. 3|S.A. 3|||
Saint Diary|Saint Diary|||
Sakura no Mori|Sakura no Mori|||
Sangokushi 3|Sangokushi 3|||
Sangokushi Eiketuden|Sangokushi Eiketuden|||
Saori|Saori|||
S.A.|S.A.|||
Sasami no Tenchi Dasshu Daisakusen!!|Sasami no Tenchi Dasshu Daisakusen!!|||
Satyr|Satyr|||
Sayaka: Gibo|Sayaka - Gibo|||
School Girls|School Girls|||
Seek|Seek|||
Sekaide Ichiban Kimiga Suki!|Sekaide Ichiban Kimiga Suki!|||
Sengoku Kyoosha Monogatari Ransei|Sengoku Kyoosha Monogatari Ransei|||
Sentimental Graphics Vol. 1|Sentimental Graphics Vol. 1|||
Sexpress|Sexpress|||
Shanglia|Shanglia|||
Shared Magic|Shared Magic|||
Shinc|Shinc|||
Shinjuku Monogatari|Shinjuku Monogatari|||
Shizuku|Shizuku|||
Shuuware no Tenshi|Shuuware no Tenshi|||
Sichuan|Sichuan|||
Silent Mobius|Silent Mobius|||
Slayers|Slayers|||
Snow Memory|Snow Memory|||
Sorcerian|Sorcerian|||
Sotsugyou Shashin|Sotsugyou Shashin|||
Sotugyo|Sotugyo|||
Space Destroyer Kuru II|Space Destroyer Kuru II|||
Star Platinum|Star Platinum|||
Star Trap|Star Trap|||
Steam Heart's|Steam Heart's|||
Strawberry Daisenryaku: Novu|Strawberry Daisenryaku - Novu|||
Strush|Strush|||
Sucharaka Junior High-School|Sucharaka Junior High-School|||
Suki!|Suki!|||
Super Battle Skin Panic|Super Battle Skin Panic|||
Super Daifugo Gakuen|Super Daifugo Gakuen|||
Super Ultra Muttin Ultra Puripri Cyborg Maririn-DX|Super Ultra Muttin Ultra Puripri Cyborg Maririn-DX|||
Supplemental Lesson|Supplemental Lesson|||
Suzaku|Suzaku|||
SWAP|SWAP|||
Sweet Angel|Sweet Angel|||
Sweet Emotion|Sweet Emotion|||
Sword Dancer Goddess of the Evil Blade|Sword Dancer Goddess of the Evil Blade|||
Sword Dancer|Sword Dancer|||
Sword Dancer Zoukan '93|Sword Dancer Zoukan '93|||
Sword Dancer Zoukango|Sword Dancer Zoukango|||
Taboo|Taboo|||
Tania|Tania|||
Tatakei!! Maitei Luna|Tatakei!! Maitei Luna|||
T.D.F.|T.D.F.|||
Tekkaman Blade|Tekkaman Blade|||
Tenchi Muyo|Tenchi Muyo|||
Tenka Toitu 2: Power Upgrade Set|Tenka Toitu 2 - Power Upgrade Set|||
Tenka Toitu 2|Tenka Toitu 2|||
Tenkousei|Tenkousei|||
The 2nd Super Witch Great War|2nd Super Witch Great War, The|||
The Legends of Lune|Legends of Lune, The|||
Themm|Themm|||
The Savage Empire|Savage Empire, The|||
The Screamer|Screamer, The|||
The Sword of Kumdor|Sword of Kumdor, The|||
The Tower of Zarbartz|Tower of Zarbartz, The|||
Thexder|Thexder|||
Thousand Cranes|Thousand Cranes|||
Throbbing Elementary School 3rd Grade|Throbbing Elementary School 3rd Grade|||
Time Stripper Makochan|Time Stripper Makochan|||
Tir-nan-og 2|Tir-nan-og 2|||
Tir-nan-og|Tir-nan-og|||
Tokimeki Sports Gal III|Tokimeki Sports Gal III|||
Tokyo Fujoku Kikoo|Tokyo Fujoku Kikoo|||
To Night|To Night|||
Toogenkyoo|Toogenkyoo|||
Trigger|Trigger|||
True Love|True Love|||
Trump Blackjack|Trump Blackjack|||
Tsumo Baka Nissi|Tsumo Baka Nissi|||
Tuned Heart|Tuned Heart|||
Turn Over|Turn Over|||
Ultima IV: The False Prophet|Ultima IV - The False Prophet|||
Ultima Underworld: The Stygian Abyss|Ultima Underworld - The Stygian Abyss|||
Uno|Uno|||
Ura Mansion Hakkin|Ura Mansion Hakkin|||
Urotsukidoji|Urotsukidoji|||
Usagina Panic|Usagina Panic|||
Usagi Panic 2|Usagi Panic 2|||
Usagi|Usagi|||
Ushinawareta Rakuen|Ushinawareta Rakuen|||
Utatane Hiroyuki no Yuwaku|Utatane Hiroyuki no Yuwaku|||
Vain Dream|Vain Dream|||
Valentine Kiss|Valentine Kiss|||
Variable Geo 2: The Bout of Cabalistic Goddess|Variable Geo 2 - The Bout of Cabalistic Goddess|||
Variable Geo 2|Variable Geo 2|||
Variable Geo|Variable Geo|||
Venus|Venus|||
Viper 12|Viper 12|||
Warlpurgis Night 3|Warlpurgis Night 3|||
Wasureenu Honou|Wasureenu Honou|||
Waterfront Adventure|Waterfront Adventure|||
Waver: The Seeker 2|Waver - The Seeker 2|||
Wonpara Wars 2|Wonpara Wars 2|||
Words Worth Special Disk|Words Worth Special Disk|||
Words Worth|Words Worth|||
World Golf II|World Golf II|||
Wrestling Angels|Wrestling Angels|||
Xak 2|Xak 2|||
Xak 3|Xak 3|||
Xak: The Tower of Gazzel|Xak - The Tower of Gazzel|||
Xak|Xak|||
Xalx Quest 98|Xalx Quest 98|||
Xanadu 2 Revival|Xanadu 2 Revival|||
Xanadu Revival|Xanadu Revival|||
Xenon|Xenon|||
Xevious|Xevious|||
X|X|||
XZR II|XZR II|||
Yan Yan no Gekitoo: Doosookai|Yan Yan no Gekitoo - Doosookai|||
Yan Yan no Quizz Icchomae|Yan Yan no Quizz Icchomae|||
Yes! HG|Yes! HG|||
Yokohama Eresy|Yokohama Eresy|||
Ys 2: Ancient Ys Vanished: The Final Chapter|Ys 2 - Ancient Ys Vanished - The Final Chapter|||
Ys 3: Wanderers from Ys|Ys 3 - Wanderers from Ys|||
Yume no Sei|Yume no Sei|||
Yumeutsutsu|Yumeutsutsu|||
Yuuwaku no Toiki|Yuuwaku no Toiki|||
Zatuon Ryooiki|Zatuon Ryooiki|||
Zenith|Zenith|||
Zikusousakan Hayate|Zikusousakan Hayate|||
