007: Licence to Kill|||Licence to Kill|
100 4 1|100 4 1|||
10th Frame|10th Frame|10th Frame|10th Frame|
180|180|||
1943: The Battle of Midway|1943 - The Battle of Midway||1943|
1944|1944|||
1st Division Manager|1st Division Manager|||
1st Serve Tennis|1st Serve Tennis|||
20,000 Leagues Under the Sea|20000 Leagues Under The Sea||20000 Leagues Under The Sea|
2-1 Bar|2-1 Bar|||
221B Baker Street|221B Baker Street|||
3-D Break-Thru|3-D Break-Thru|||
3-D Galax|3-D Galax|||
3D Labyrinth|3D Labyrinth|||
3D Maze|3D Maze|||
3-D Pool|3-D Pool|||
3D Ski|3D Ski|||
3-D Soccer|3-D Soccer|||
4-7-11|4-7-11|||
500cc Grand Prix||500cc Grand Prix||
5 Intelligent Strategy Games|5 Intelligent Strategy Games|||
5 of a Kind|5 of a Kind|||
5 Shot|5 Shot|||
5th Gear|5th Gear|5th Gear||
8 Ball|8 Ball|||
9 Lives|9 Lives|||
A320 Airbus|A320 Airbus|||
AAARGH!|Aaargh!|||
Abombinaball|Abombinaball|||
ABZoo|ABZoo|||
Academy: Tau Ceti II|Academy - Tau Ceti II|Academy - Tau Ceti II||
Action Fighter|Action Fighter|Action Fighter||
Action Service|Action Service|Action Service||
Addams Family|Addams Family|||
Addictaball|Addictaball|Addictaball||
Adidas Championship Tie Break|Adidas Championship Tie Break|Adidas Championship Tie Break||
Adrenalynn|Adrenalynn|||
ADS: Advanced Destroyer Simulator|ADS - Advanced Destroyer Simulator|||
Advanced Dungeons & Dragons: Heroes of the Lance: A DragonLance Action Game||Advanced Dungeons & Dragons - Heroes of the Lance - A DragonLance Action Game||
Advanced Fruit Machine Simulator|Advanced Fruit Machine Simulator|Advanced Fruit Machine Simulator||
Advanced Rugby Simulator|Advanced Rugby Simulator|Advanced Rugby Simulator||
Advanced Ski Simulator|Advanced Ski Simulator|||
Advantage Tennis|Advantage Tennis|||
Adventures of Maddog Williams, The: The Dungeons of Duridian|Adventures of Maddog Williams, The - The Dungeons of Duridian|||
Affaire, L'|Affaire, L'|||
African Raiders|African Raiders|||
Afrika Korps|Afrika Korps|||
After Burner|After Burner|Afterburner||
After the War|After The War|||
AGE: Advanced Galactic Empire|AGE - Advanced Galactic Empire|||
Aigle d'Or, L'|Aigle d'Or, L'|||
Airball|Airball|||
Airborne Ranger|Airborne Ranger|||
Air Bucks|Air Bucks|||
Air Supply|Air Supply|||
Air Support|Air Support|||
Air Warrior 1.1|Air Warrior 1.1|||
Air Warrior 2.0|Air Warrior 2.0|||
Albedo|Albedo|||
Alcatraz|Alcatraz|||
Alcon|Alcon|||
ALF: The First Adventure|Alf - The First Adventure|||
Aliants: The Desperate Battle for Earth|Aliants - The Desperate Battle for Earth|||
Alienation|Alienation|||
Alien Blast|Alien Blast|||
Alien Busters IV|Alien Busters IV|||
Alien Fires 2199 AD|Alien Fires 2199 AD|||
Alien Storm|Alien Storm|||
Alien Syndrome|Alien Syndrome|||
Alien Thing|Alien Thing|||
Alien Thing: Expert Edition|Alien Thing - Expert Edition|||
Alien World|Alien World|Alien World||
All Aboard! Micro Gauge Train Set|All Aboard! Micro Gauge Train Set|||
All Blocked Up|All Blocked Up|||
Alphabet Mix|Alphabet Mix|||
Alphamax|Alphamax|||
Alpha Waves|Alpha Waves|||
Alpine Games|Alpine Games|||
Altair|Altair|||
Altered Beast|Altered Beast|||
Alternate Reality: The City||Alternate Reality - The City||
Alternate Reality: The City|Alternate Reality - The City|||
Amazeing|Amazeing|||
Amazon|Amazon|||
Amberstar|Amberstar|||
AMC: Astro Marine Corps|AMC - Astro Marine Corps|||
Ammotrack|Ammotrack|||
Anarchy Academy|Anarchy Academy|||
Anarchy|Anarchy|Anarchy||
Ancient Battles|Ancient Battles|||
Ancient Games|Ancient Games|||
Andes Attack|Andes Attack|||
Andromeda|Andromeda|||
Anduril|Anduril|||
Ange de Cristal, L'|Ange de Cristal, L'|||
Angel Nieto Pole 500|Angel Nieto Pole 500|||
Animal Kingdom|Animal Kingdom|||
Annals of Rome|Annals Of Rome|||
Annex|Annex|||
Annihilator|Annihilator|||
Another World|Another World|Another World||
Antago|Antago|||
Apache Flight|Apache Flight|||
A.P.B.: All Points Bulletin|A.P.B. - All Points Bulletin|||
...A Personal Nightmare|||Personal Nightmare|
Apprentice|Apprentice|Apprentice||
Aquanaut|Aquanaut|||
Arcade Fruit Machine|Arcade Fruit Machine|||
Arcade Mania|Arcade Mania|||
Arcade Trivia Quiz|Arcade Trivia Quiz|||
Archer Maclean's Pool|Archer MacLean's Pool|||
Archipelagos|Archipelagos|Archipelagos||
Arcticfox||Arcticfox||
Arctic Fox|Arctic Fox|||
Arctic Moves|Arctic Moves|||
Arena|Arena|||
Arkanoid|Arkanoid|||
Arkanoid III|Arkanoid III|||
Arkanoid II: Revenge of Doh|Arkanoid II - Revenge of Doh|||
Armada|Armada|||
Armageddon Man, the|Armageddon Man, the|||
Armalyte|Armalyte|||
Armoured Operation|Armoured Operation|||
Armour-Geddon|Armour-Geddon|||
Army Moves|Army Moves|||
Around the World|Around the World|||
Arthur of the Britons|Arthur of the Britons|||
Artificial Dreams|Artificial Dreams|Artificial Dreams||
Artura|Artura|||
Astaroth|Astaroth|||
Astate|Astate|||
Asterix: Operation Getafix|Asterix - Operation Getafix|||
Asteroidia|Asteroidia|||
Asteroids|Asteroids|||
Asteroids Deluxe|Asteroids Deluxe|||
Astro 2000|Astro 2000|||
AstroPanic 94!|AstroPanic 94!|||
AstroPanic!|AstroPanic!|||
Atari Grand Prix|Atari Grand Prix|||
Atax|Atax|Atax||
ATF II: Advanced Tactical Fighter II|ATF II - Advanced Tactical Fighter II|||
Atomic RoboKid|Atomic RoboKid|||
Atomino|Atomino|||
Atomix|Atomix|Atomix||
Aussie Joker Poker|Aussie Joker Poker|||
Austerlitz|Austerlitz|||
Auto Duel|Auto Duel|||
AV-8B Harrier Assault|AV-8B Harrier Assault|||
Avina Blue|Avina Blue|||
Awesome|Awesome|||
Axel's Magic Hammer|Axel's Magic Hammer|||
Axis|Axis|||
Azarian|Azarian|||
B17: Flying Fortress|B17 - Flying Fortress|||
Baal|Baal|||
Baby Jo: Going Home|Baby Jo - Going Home|||
Backgammon|Backgammon|||
Backgammon Royale|Backgammon Royale|Backgammon Royale||
Backlash|Backlash|||
Back to the Future II|Back to the Future II|||
Back to the Future III|Back to the Future III|||
Back to the Golden Age|Back to the Golden Age|||
Bad Cat|Bad Cat|||
Bad Company|Bad Company|||
Bad Dudes vs. Dragon Ninja|Bad Dudes vs. Dragon Ninja|||
Badlands|Badlands|||
Badlands Pete|Badlands Pete|||
Baker Street Detective|Baker Street Detective|||
Balance of Power|Balance of Power|||
Balance of Power: The 1990 Edition|Balance of Power - The 1990 Edition|Balance of Power - The 1990 Edition||
Ballistix|Ballistix|Ballistix||
Balls Quest|Balls Quest|||
Balls Up|Balls Up|||
Ballyhoo|Ballyhoo|||
Ball Zone|Ball Zone|||
Bambino and the Puzzle|Bambino and the Puzzle|||
Bang and Blast Man|Bang and Blast Man|||
Bangkok Knights|Bangkok Knights|||
Bank Buster|Bank Buster|||
Bank-It|Bank-It|||
Barbarian|Barbarian|||
Barbarian II|Barbarian II|||
Barbarian II: The Dungeon of Drax|Barbarian II - The Dungeon of Drax|||
Barbarian: The Ultimate Warrior|Barbarian - The Ultimate Warrior|Barbarian - The Ultimate Warrior||
Bard's Tale, The : Tales of the Unknown|Bard's Tale, The  - Tales of the Unknown|||
Bargon Attack|Bargon Attack|||
B.A.T.|B.A.T.|||
B.A.T. II|B.A.T. II|||
Batman: The Caped Crusader|Batman - The Caped Crusader|||
Batman: The Movie|Batman - The Movie|||
Battle Bound|Battle Bound|||
Battle Chess|Battle Chess|Battle Chess||
Battle Command|Battle Command|||
Battlehawks 1942|Battlehawks 1942|Battlehawks 1942||
Battlemaster|Battlemaster|||
Battle Of The Atlantic: The Ocean Lifeline 1940-1944)|Battle Of The Atlantic - The Ocean Lifeline 1940-1944)|||
Battle Probe|Battle Probe|Battle Probe||
Battleships|Battleships|||
Battletech|Battletech|||
Battletris|Battletris|||
Battletris+|Battletris+|||
Battlezone|BattleZone|||
Bauernkampf|Bauernkampf|||
Beach Volley|Beach Volley|Beach Volley||
Beam|Beam|||
Beast Busters|Beast Busters|||
Beastlord||Beastlord||
Beast Lord|Beast Lord|||
Bellum|Bellum|||
Ben in Paradise|Ben in Paradise|||
Bentley Bear's Equation Builder|Bentley Bear's Equation Builder|||
Bentley Bear's General Store|Bentley Bear's General Store|||
Bentley Bear's Magical Anagrams|Bentley Bear's Magical Anagrams|||
Bentley Bear's Magical Math 1|Bentley Bear's Magical Math 1|||
Bentley Bear's Magical Math II|Bentley Bear's Magical Math II|||
Bentley Bear's Magical Math III|Bentley Bear's Magical Math III|||
Bentley Bear's Memory Master II|Bentley Bear's Memory Master II|||
Bentley Bear's Spelling Bee|Bentley Bear's Spelling Bee|||
Bentley Bear's Typing Tutor|Bentley Bear's Typing Tutor|||
Bermuda Project|Bermuda Project|||
Bert the Squirt|Bert The Squirt|||
Berzerk|Berzerk|||
Betrayal|Betrayal|||
Better Dead Than Alien!|Better Dead Than Alien!|||
Beverly Hills Cop|Beverly Hills Cop|||
Beyond the Ice Palace|Beyond the Ice Palace|Beyond the Ice Palace||
Beyond The Titanic II|Beyond The Titanic II|||
Beyond Zork: The Coconut of Quendor|Beyond Zork - The Coconut of Quendor|||
Big Business|Big Business|||
Big Game Fishing|Big Game Fishing|||
Big Nose|Big Nose|||
Big Run|Big Run|||
Biker|Biker|||
Billiards Simulator|Billiards Simulator|||
Billiards Simulator II|Billiards Simulator II|||
Billy Bounce|Billy Bounce|||
Billy Boy|Billy Boy|||
Bio Challenge|Bio Challenge|||
Biohazard|Biohazard|||
Bionic Commando|Bionic Commando|||
Bismarck|Bismarck|||
Black Box|Black Box|||
Black Hornet|Black Hornet|||
Blackjack Plus III|Blackjack Plus III|||
Black Lamp|Black Lamp|||
Black Orchid|Black Orchid|||
Blackscar Mountain|Blackscar Mountain|||
Black Sectt|Black Sectt|||
Black Tiger|Black Tiger|Black Tiger||
Black & White|Black & White|||
Blastaball|Blastaball|||
Blast|Blast|||
Blaster|Blaster|||
Blasteroids|Blasteroids|Blasteroids||
Blazing Thunder|Blazing Thunder|Blazing Thunder||
Blinky's Scary School|Blinky's Scary School|||
Blitzkrieg May 1940|Blitzkrieg May 1940|||
Blobb Run|Blobb Run|||
Blob Race|Blob Race|||
Blockbuster|Blockbuster|||
Blockout||Blockout||
Block Out|Block Out|||
Blood Fever|Blood Fever|||
Blood Money|Blood Money|Blood Money||
Blood 'N' Bullets|Blood 'N' Bullets|||
Bloodwych|Bloodwych|||
Bloodwych: The Extended Levels|Bloodwych - The Extended Levels|||
Blue Angel 69|Blue Angel 69|||
Blue Angels|Blue Angels|||
Blue Max|Blue Max|||
Blue War III|Blue War III|||
BMX Simulator|BMX Simulator|BMX Simulator||
Bobbles!|Bobbles!|||
Bob Morane: Chevalerie I|Bob Morane - Chevalerie I|||
Bob Morane: Jungle|Bob Morane - Jungle|||
Bob Morane: Ocean|Bob Morane - Ocean|||
Bob Morane: Science Fiction|Bob Morane - Science Fiction|||
Bobo|Bobo|||
Bob Winner|Bob Winner|Bob Winner||
Boing|Boing|||
Bold|Bold|||
Bolo|Bolo|||
Bomber Command|Bomber Command|||
Bomb Fusion|Bomb Fusion|||
Bomb Jack|Bomb Jack|Bomb Jack||
Bombs Away|Bombs Away|||
Bombuzal|Bombuzal|||
Bomb'X: Euroswap|Bomb'X - Euroswap|||
Bomb'X Supremacy: Extention 1|Bomb'X Supremacy - Extention 1|||
Bomb'X Supremacy: Extention 2|Bomb'X Supremacy - Extention 2|||
Bomb'X Supremacy: Extention 3|Bomb'X Supremacy - Extention 3|||
Bomb'X: Vectronix|Bomb'X - Vectronix|||
Bonanza Bros|Bonanza Bros|||
Book of Moebius|Book of Moebius|||
Booly|Booly|||
Bootiful Babe|Bootiful Babe|||
Border Warfare|Border Warfare|||
Border Zone|Border Zone|||
Borodino|Borodino|||
Borrowed Time|Borrowed Time|||
Boston Bomb Club|Boston Bomb Club|||
Botics|Botics|||
Boulder Dash|Boulder Dash|||
Boulder Dash Construction Kit|Boulder Dash Construction Kit|||
Bounce Out|Bounce Out|||
Brad Stallion in Sex Olympics|Brad Stallion in Sex Olympics|||
Brainbox|Brainbox|||
Brataccas|Brataccas|||
Brat|Brat|||
Breach 2|Breach 2|||
Breach|Breach|||
Breakanoid|Breakanoid|||
Breakers|Breakers|||
Breakout|Breakout|||
Brian Clough's Football Fortunes|Brian Clough's Football Fortunes|||
Brick Busta|Brick Busta|||
Bride of the Robot|Bride of the Robot|||
Brides of Dracula|Brides of Dracula|||
Bridge 2000|Bridge 2000|||
Bridge|Bridge|||
Bridge Master||Bridge Master||
Bridge Player 2000 with Tutor|Bridge Player 2000 with Tutor|Bridge Player 2000 with Tutor||
Bridge Player Galactica|Bridge Player Galactica|||
Bridge Tutor|Bridge Tutor|||
Brimstone: The Dream Of Garwin|Brimstone - The Dream Of Garwin|||
Bubble Bobble 2|Bubble Bobble 2|||
Bubble Bobble|Bubble Bobble|||
Bubble Bobble: Extended Screens|Bubble Bobble - Extended Screens|||
Bubble Bobble Strikes Again|Bubble Bobble Strikes Again|||
Bubble +|Bubble +|||
Bubble Dizzy|Bubble Dizzy|||
Bubble Ghost|Bubble Ghost|||
Bubble Trouble|Bubble Trouble|||
Buffalo Bill's Wild West Show|Buffalo Bill's Wild West Show|||
Bug Bash|Bug Bash|||
Buggy Boy|Buggy Boy|||
Bugs|Bugs|||
Bug Spray|Bug Spray|||
Builderland: The Story of Melba|Builderland - The Story of Melba|||
Bullet Train|Bullet Train|||
Bully's Sporting Darts|Bully's Sporting Darts|||
Bumpy|Bumpy|Bumpy||
Bumpy's Arcade Fantasy|Bumpy's Arcade Fantasy|||
Bundesliga Manager Professional|Bundesliga Manager Professional|||
Bunny Bricks|Bunny Bricks|||
Bureaucracy|Bureaucracy|||
Burger Man|Burger Man|Burger Man||
Butcher Hill|Butcher Hill|||
Buzzword|Buzzword|||
Cabal|Cabal|||
Cadaver 3|Cadaver 3|||
Cadaver|Cadaver|||
Cadaver: The Pay Off|Cadaver - The Pay Off|||
Caesar|Caesar|||
California Games|California Games|||
California Games II|California Games II|||
California Goldrush|California Goldrush|||
Campaign|Campaign|||
Cannon Fodder|Cannon Fodder|||
Cap'n'Carnage|Cap'n'Carnage|||
Captain America Defies the Doom Tube|Captain America Defies the Doom Tube|||
Captain Blood|Captain Blood|Captain Blood||
Captain Cremmin|Captain Cremmin|||
Captain Dynamo|Captain Dynamo|||
Captain Fizz|Captain Fizz|||
Captain Fizz Meets the Blaster-Trons||Captain Fizz Meets the Blaster-Trons||
Captain Planet and the Planeteers|Captain Planet and the Planeteers|||
Captive|Captive|||
Cards 2.0|Cards 2.0|||
Carlos|Carlos|||
Carrier Command|Carrier Command|Carrier Command||
Cartoon Capers|Cartoon Capers|Cartoon Capers||
Car-Vup|Car-Vup|||
Casino Craps|Casino Craps|||
Casino Roulette|Casino Roulette|||
Castle Capers|Castle Capers|||
Castle Master|Castle Master|||
Castle Master II: The Crypt|Castle Master II - The Crypt|||
Castles|Castles|||
Castle Warrior|Castle Warrior|||
Catch 23|Catch 23|Catch 23||
Cave Mania|Cave Mania|||
Cave Runner II: Caverns of Death|Cave Runner II - Caverns Of Death|||
Centerfold Squares|Centerfold Squares|||
Centipede|Centipede|||
Challenge Foot Junior|Challenge Foot Junior|||
Challenge Golf|Challenge Golf|||
Chambers of Shaolin|Chambers of Shaolin|||
Chamonix Challenge|Chamonix Challenge|||
Champion of the Raj|Champion of the Raj|||
Championship Baseball|Championship Baseball|Championship Baseball||
Championship Cricket|Championship Cricket|Championship Cricket||
Championship Manager '93|Championship Manager '93|||
Championship Manager|Championship Manager|||
Championship Manager End of Season 1994|Championship Manager End of Season 1994|||
Championship Manager Italia|Championship Manager Italia|||
Championship Run|Championship Run|||
Championship Water-Skiing|Championship Water-Skiing|||
Championship Wrestling|Championship Wrestling|Championship Wrestling||
Chaos|Chaos|||
Chaos Strikes Back|Chaos Strikes Back|||
Charge of the Light Brigade|Charge of the Light Brigade|||
Chariots of Wrath|Chariots of Wrath|||
Chase|Chase|Chase||
Chase H.Q.||Chase H.Q.||
Chase HQ|Chase HQ|||
Chase HQ II|Chase HQ II|||
Checkmate|Checkmate|||
Chemicon|Chemicon|||
Chessbase|Chessbase|||
Chess Champion 2175|Chess Champion 2175|||
Chessnut|Chessnut|||
Chess Player 2150|Chess Player 2150|Chess Player 2150||
Chess Simulator|Chess Simulator|Chess Simulator||
Chicago 30's|Chicago 30's|Chicago 30's||
Chicago 90|Chicago 90|||
Chinese Karate|Chinese Karate|||
Chip's Challenge||Chip's Challenge||
Chips Challenge|Chips Challenge|||
Chopper X|Chopper X|||
Chrono Quest|Chrono Quest|||
Chrono Quest II|Chrono Quest II|Chrono Quest II||
Chubby Christle|Chubby Christle|||
Chu Chu Rocket|Chu Chu Rocket|||
Chuckie Egg|Chuckie Egg|Chuckie Egg||
Chuckie Egg II|Chuckie Egg II|Chuckie Egg II||
Chuck Rock|Chuck Rock|||
Chuck Yeager's Advanced Flight Trainer|Chuck Yeager's Advanced Flight Trainer|||
Cinko|Cinko|||
Circus Attractions|Circus Attractions|||
Circus Games|Circus Games|||
Cisco Heat|Cisco Heat|||
Civilization|Civilization|||
CJ in the USA|CJ in the USA|||
CJ's Elephants Antics|CJ's Elephants Antics|||
Classiques I|Classiques I|||
Clever & Smart|Clever & Smart|||
Clogged Up|Clogged Up|||
Cloud Kingdoms|Cloud Kingdoms|Cloud Kingdoms||
Clown-O-Mania|Clown-O-Mania|||
Club Backgammon|Club Backgammon|||
Club Dominoes|Club Dominoes|||
Clue: Master Detective|Clue - Master Detective|||
Cobra II|Cobra II|||
CoCoCoPo|CoCoCoPo|||
Codename Iceman|Codename Iceman|||
Cohort: Fighting for Rome|Cohort - Fighting for Rome|||
Cohort II: Fighting for Rome|Cohort II - Fighting for Rome|||
Colonial Conquest|Colonial Conquest|||
Colorado|Colorado|||
Color Clash|Color Clash|||
Colossus Chess X|Colossus Chess X|||
Columns|Columns|||
Columns II|Columns II|||
Combat|Combat|||
Combo Racer|Combo Racer|||
Commando|Commando|||
Companion I: Opening Moves|Companion I - Opening Moves|||
Computer Scrabble|Computer Scrabble|||
Computer Scrabble DeLuxe|Computer Scrabble DeLuxe|||
Conflict: Europe|Conflict - Europe|||
Conflict: The Middle East Simulation|Conflict - The Middle East Simulation|||
Confusion|Confusion|||
Conqueror|Conqueror|||
Conquests of Camelot|Conquests of Camelot|||
Conquests of Camelot: The Search for the Grail||Conquests of Camelot - The Search for the Grail||
Continental Circus|Continental Circus|Continental Circus||
Cool Croc Twins|Cool Croc Twins|||
Cool World|Cool World|||
Cops and Robbers Chess|Cops and Robbers Chess|||
Corona Magica, La|Corona Magica, La|||
Corruption|Corruption|Corruption||
Corsarios|Corsarios|||
Cortizone|Cortizone|||
Cosmic Pirate|Cosmic Pirate|||
Cosmos|Cosmos|||
Cougar Force|Cougar Force|||
Count Duckula|Count Duckula|||
Count Duckula II|Count Duckula II|||
Counter Atak|Counter Atak|||
Countout|Countout|||
Crack Down|Crack Down|Crack Down||
Crack'ed|Crack'ed|||
Crafton & Xunk|Crafton & Xunk|||
Crapman|Crapman|||
Crash Garrett|Crash Garrett|||
Crazy Cars|Crazy Cars|||
Crazy Cars II|Crazy Cars II|||
Crazy Cars III|Crazy Cars III|||
Crazy Shot|Crazy Shot|||
Creatures|Creatures|||
Creepy|Creepy|||
Cricket Captain|Cricket Captain|Cricket Captain||
Crime City|Crime City|||
Crime Does Not Pay|Crime Does Not Pay|||
Crime Wave|Crime Wave|||
Crimson Crown|Crimson Crown|||
Critical Mass|Critical Mass|||
Cromo|Cromo|||
Crossbow, The Legend of William Tell|Crossbow, The Legend of William Tell|||
Crossland|Crossland|||
Crown|Crown|||
Cruise for a Corpse|Cruise for a Corpse|||
Cruisin' Beasts|Cruisin' Beasts|||
Crystal Castles|Crystal Castles|Crystal Castles||
Crystal Kingdom Dizzy|Crystal Kingdom Dizzy|||
Crystals Of Aborea|Crystals Of Aborea|||
Curse of the Azure Bonds|Curse Of the Azure Bonds|||
Custodian|Custodian|||
Cutthroats|Cutthroats|||
Cyber Assault|Cyber Assault|||
Cyberball|Cyberball|Cyberball||
Cybercon III|Cybercon III|Cybercon III||
Cybercop|Cybercop|||
Cyberdrome|Cyberdrome|||
Cybermind|Cybermind|||
Cybernetix|Cybernetix|||
Cybernoid|Cybernoid|||
Cybernoid II|Cybernoid II|||
Cyclotron|Cyclotron|||
Cyclotron II|Cyclotron II|||
Daily Double|Daily Double|||
Dalek Attack|Dalek Attack|||
Daley Thompson's Olympic Challenge|Daley Thompson's Olympic Challenge|||
Dal'X|Dal'X|||
Dam|Dam|||
Dames Grand-Maitre|Dames Grand-Maitre|||
Dames Simulator||Dames Simulator||
Dan Dare III: The Escape|Dan Dare III - The Escape|||
Darius +|Darius +|||
Darius+||Darius+||
Dark Castle|Dark Castle|||
Dark Century|Dark Century|||
Dark Fusion|Dark Fusion|||
Darkland|Darkland|||
Darklyte|Darklyte|||
Darklyte II|Darklyte II|||
Darkman|Darkman|||
Dark-Sat|Dark-Sat|||
Dark Side|Dark Side|||
Day at the Races, A|Day at the Races, A|||
Day of the Pharaoh|Day of the Pharaoh|||
Day of the Viper|Day of the Viper|Day of the Viper||
Days of Thunder|Days of Thunder|||
D-Day|D-Day|||
Deadland|Deadland|||
Deadline|Deadline|||
Dead or Alive|Dead or Alive|||
Deathbringer|Deathbringer|||
Death Camp|Death Camp|||
Deathstrike|Deathstrike|||
Death Sword|Death Sword|||
Death Trap|Death Trap|||
Debut|Debut|||
Decimal Dungeon|Decimal Dungeon|||
Deep Lair|Deep Lair|||
Deep Space|Deep Space|||
Defender II|Defender II|||
Defender of the Crown|Defender of the Crown|||
Defenders of Earth|Defenders of Earth|||
Deflektor|Deflektor|||
Deja Vu: A Nightmare Comes True!||Deja Vu - A Nightmare Comes True!||
Deja Vu|Deja Vu|||
Deja Vu II|Deja Vu II|||
Deliverance|Deliverance|Deliverance||
Delta Patrol|Delta Patrol|||
Deluxe Invaders|Deluxe Invaders|||
Deluxe Nostram|Deluxe Nostram|||
Demenage Man|Demenage Man|||
Demon Axis|Demon Axis|||
Demon Blue|Demon Blue|Demon Blue||
Demoniac|Demoniac|||
Demoniak|Demoniak|Demoniak||
Demon's Tomb: The Awakening|Demon's Tomb - The Awakening|||
Demon's Winter|Demon's Winter|||
Dennis Wheatley Presents a Murder Mystery: Herewith the Clues|Dennis Wheatley Presents a Murder Mystery - Herewith the Clues|||
Derrick the Droid|Derrick the Droid|||
Desolator|Desolator|||
Destruction Imminent|Destruction Imminent|||
Detonater|Detonater|||
Deuteros|Deuteros|||
Devious Designs|Devious Designs|||
Devon Aire in the Hidden Diamond Caper|Devon Aire in the Hidden Diamond Caper|||
DGDB 2|DGDB 2|||
DGDB|DGDB|||
D-Generation|D-Generation|||
Diablo|Diablo|||
Diamond Ice|Diamond Ice|||
Dick Tracy|Dick Tracy|Dick Tracy||
Die Hard 2|Die Hard 2|||
Diplomacy|Diplomacy|||
Disc|Disc|Disc||
Disciples of Steel|Disciples of Steel|||
Discovery: In The Steps Of Columbus)|Discovery - In The Steps Of Columbus)|||
Dive Bomber|Dive Bomber|||
Division One '92|Division One '92|||
Dizzy Dice|Dizzy Dice|Dizzy Dice||
Dizzy Lizzy|Dizzy Lizzy|||
Dizzy Lizzy II: A Winters Tale|Dizzy Lizzy II - A Winters Tale|||
Dizzy Panic|Dizzy Panic|||
Dizzy Wizard|Dizzy Wizard|||
Doctor Doom's Revenge|Doctor Doom's Revenge|||
Dogfight|Dogfight|||
Dogs of War|Dogs of War|||
Domination|Domination|||
Dominator|Dominator|||
Dominium|Dominium|||
Donald Duck's Playground|Donald Duck's Playground|||
Donald's Alphabet Chase|Donald's Alphabet Chase|||
Doodle Bug|Doodle Bug|||
Do! Run Run|Do! Run Run|||
Double Dare|Double Dare|||
Double Dragon 3: The Rosetta Stone|Double Dragon 3 - The Rosetta Stone|||
Double Dragon|Double Dragon|Double Dragon||
Double Dragon II: The Revenge||Double Dragon II - The Revenge||
Double Dragon II: The Revenge|Double Dragon II - The Revenge|||
Double Juggle Vegatabobble|Double Juggle Vegatabobble|||
Douglas Rockmoor 2|Douglas Rockmoor 2|||
Douglas Rockmoor|Douglas Rockmoor|||
Down Fall|Down Fall|||
Dozer|Dozer|||
Drachen|Drachen|||
Dragon Breed|Dragon Breed|||
Dragonflight|Dragonflight|||
Dragon Force|Dragon Force|||
Dragonlord|Dragonlord|||
Dragons Breath|Dragons Breath|||
Dragonscape|Dragonscape|||
Dragon's Lair|Dragon's Lair|||
Dragon's Lair: Escape from Singe's Castle|Dragon's Lair - Escape from Singe's Castle|||
Dragon's Lair II|Dragon's Lair II|||
Dragon's Lair III|Dragon's Lair III|||
Dragons of Flame|Dragons of Flame|||
Dragon Spirit|Dragon Spirit|Dragon Spirit||
Drakkhen|Drakkhen|Drakkhen||
Dreadnoughts|Dreadnoughts|||
Dream Zone|Dream Zone|||
Driller|Driller|Driller||
Drivin' Force|Drivin' Force|||
Dr. Necro|Dr. Necro|||
Droid 2|Droid 2|||
Droid|Droid|||
Droid II|Droid II|||
Droid III|Droid III|||
Drops|Drops|||
Duck Dash|Duck Dash|||
Duck Tales: The Quest for Gold|Duck Tales - The Quest for Gold|||
Dugger|Dugger|||
Dungeon|Dungeon|||
Dungeon Lord|Dungeon Lord|||
Dungeon Master|Dungeon Master|||
Dungeon Master II: The Legend of Skulldeep|Dungeon Master II - The Legend of Skulldeep|||
Dungeons, Amethysts, Alchemists'n Everythin'|Dungeons, Amethysts, Alchemists'n Everythin'|||
Dweabys Quest|Dweabys Quest|||
Dynablaster|Dynablaster|||
Dynabusters+|Dynabusters+|||
Dynamite Dux|Dynamite Dux|||
Dynamo|Dynamo|||
Dynasty Wars|Dynasty Wars|Dynasty Wars||
Dysprosm|Dysprosm|||
Dyter-07|Dyter-07|||
Eagle's Rider|Eagle's Rider|||
Easter Eggstravaganza Dizzy|Easter Eggstravaganza Dizzy|||
East vs. West Berlin 1948||East vs. West Berlin 1948||
East vs. West: Berlin 1948|East vs. West - Berlin 1948|||
Eco|Eco|||
Eco Phantoms|Eco Phantoms|||
Eddie Edwards Super Ski|Eddie Edwards Super Ski|||
Edd the Duck!|Edd the Duck!|||
Eden Blues.|Eden Blues.|||
Eighth Army|Eighth Army|||
Electronic Pool|Electronic Pool|||
Elemental|Elemental|Elemental||
Elf|Elf|Elf||
Eliminator|Eliminator|||
Elite|Elite|Elite||
Elvira II: The Jaws of Cerberus|Elvira II - The Jaws of Cerberus|||
Elvira: Mistress of the Dark|Elvira - Mistress of the Dark|||
Elvira: The Arcade Game|Elvira - The Arcade Game|||
Emlyn Hughes Arcade Quiz|Emlyn Hughes Arcade Quiz|||
Emlyn Hughes International Soccer|Emlyn Hughes International Soccer|||
Emmanuelle|Emmanuelle|||
E-Motion|E-Motion|||
Emperor of the Mines|Emperor of the Mines|||
Empire Builder|Empire Builder|||
Empire: Wargame of the Century|Empire - Wargame of the Century|||
Enchanted Land|Enchanted Land|||
Enchanter|Enchanter|||
Encounter|Encounter|||
Encyclopedia of War: Ancient Battles|Encyclopedia of War - Ancient Battles|||
Endurance|Endurance|||
Enduro Racer|Enduro Racer|||
England Championship Special|England Championship Special|||
England Team Manager|England Team Manager|||
Enigme a Oxford|Enigme a Oxford|||
Enterprise|Enterprise|Enterprise||
Entombed|Entombed|||
Epic|Epic|||
Erebus|Erebus|||
Ergon|Ergon|||
Erik|Erik|Erik||
Escapade|Escapade|||
Escape from the Planet of the Robot Monsters|Escape from the Planet of the Robot Monsters|||
Eskimo Games|Eskimo Games|||
Espionage|Espionage|||
Esprit|Esprit|||
ESS: European Space Simulator|ESS - European Space Simulator|||
Essex|Essex|||
E-SWAT: Cyber Police|E-Swat - Cyber Police|||
European Champions|European Champions|||
European Championship 1992|European Championship 1992|||
European Football Champ|European Football Champ|||
European Soccer Challenge|European Soccer Challenge|||
European Superleague|European Superleague|||
Eurosoccer '88|Eurosoccer '88|||
Evader|Evader|||
Evasion 2|Evasion 2|||
Evasion|Evasion|||
Everton FC Intelligensia|Everton FC Intelligensia|||
Exile|Exile|||
Exodrom|Exodrom|||
Exodus|Exodus|||
Exolon|Exolon|Exolon||
Extase|Extase|||
Extensor|Extensor|||
Exterminate|Exterminate|||
Exterminator|Exterminator|||
Eye|Eye|||
Eye of Horus||Eye of Horus||
F-15 Strike Eagle|F-15 Strike Eagle|||
F-15 Strike Eagle II|F-15 Strike Eagle II|||
F-16 Combat Pilot|F-16 Combat Pilot|||
F-19 Stealth Fighter|F-19 Stealth Fighter|F-19 Stealth Fighter||
F1|F1|||
F1 Manager|F1 Manager|||
F1 Tornado|F1 Tornado|||
F29 Retaliator|F29 Retaliator|||
Face Off|Face Off|||
Face-Off|Face-Off|||
Face-Off Ice Hockey||Face-Off Ice Hockey||
Fahrenheit 451|Fahrenheit 451|||
Falcon|Falcon|||
Falcon Mission Disk Volume I|Falcon Mission Disk Volume I|||
Falcon Mission Disk Volume II|Falcon Mission Disk Volume II|||
Fallen Angel|Fallen Angel|||
Fallers|Fallers|||
Famous Five, The: Five On A Treasure Island|Famous Five, The - Five On A Treasure Island|||
Fantasy World Dizzy|Fantasy World Dizzy|||
Fascination|Fascination|||
Fast Food|Fast Food|||
Fast Lane|Fast Lane|||
Fate: Gates of Dawn|Fate - Gates of Dawn|||
Fate Master|Fate Master|||
FC Manager|FC Manager|||
Federation of Free Traders|Federation of Free Traders|||
Federation Quest I: BSS Jane Seymour|Federation Quest I - BSS Jane Seymour|||
Fernandez Must Die|Fernandez Must Die|||
Ferrari Formula One|Ferrari Formula One|||
Fetiche Maya, Le|Fetiche Maya, Le|||
Feudal Lords|Feudal Lords|||
Fiendish Freddy's Big Top 'O Fun|Fiendish Freddy's Big Top 'O Fun|||
Fighter Bomber: Advanced Mission Disc|Fighter Bomber - Advanced Mission Disc|||
Fighter Bomber|Fighter Bomber|||
Fighter Command|Fighter Command|||
Fighting Soccer|Fighting Soccer|||
Final Assault|Final Assault|||
Final Blow|Final Blow|||
Final Command|Final Command|||
Final Fight|Final Fight|||
Final Legacy|Final Legacy|||
Fire and Brimstone|Fire and Brimstone|||
Fire and Forget|Fire and Forget|||
Fire and Forget II: The Death Convoy|Fire and Forget II - The Death Convoy|Fire and Forget II - The Death Convoy||
Fire and Ice|Fire and Ice|||
Fireball|Fireball|||
Fireblaster|Fireblaster|||
Fire Brigade: The Battle For Kiev 1943|Fire Brigade - The Battle For Kiev 1943|||
Fire!|Fire!|||
Fire Force|Fire Force|||
Firehawk|Firehawk|||
Fire Mission|Fire Mission|||
Fire Rescue|Fire Rescue|||
Firestar|Firestar|||
Firezone|Firezone|||
First Contact|First Contact|||
First Person Pinball|First Person Pinball|||
Fish!|Fish!|||
Fist of Fury|Fist of Fury|||
Flight Levels|Flight Levels|||
Flight of the Intruder|Flight of the Intruder|||
Flight Simulator II|Flight Simulator II|||
Flimbo's Quest|Flimbo's Quest|Flimbo's Quest||
Flintstones|Flintstones|||
Flip-Flop|Flip-Flop|||
Flip-it & Magnose: Water Carriers from Mars|Flip-it & Magnose - Water Carriers From Mars|||
Flipside|Flipside|||
Flood|Flood|||
Floyd the Droid 'On The Run'|Floyd the Droid 'On The Run'|||
Fluffies|Fluffies|||
Flying Shark|Flying Shark|||
Fly Robin Fly|Fly Robin Fly|||
Food Fight|Food Fight|||
Football Champ|Football Champ|||
Football Crazy|Football Crazy|||
Football Director|Football Director|||
Football Director II|Football Director II|||
Footballer of the Year 2|Footballer of the Year 2|||
Football Manager 2: Expansion Kit|Football Manager 2 - Expansion Kit|||
Football Manager 2|Football Manager 2|Football Manager 2||
Football Manager|Football Manager|||
Football Manager: World Cup Edition|Football Manager - World Cup Edition|||
Football Masters|Football Masters|||
Football Simulation|Football Simulation|||
Forbidden Quest|Forbidden Quest|||
Forgotten Worlds|Forgotten Worlds|||
Formula 1 Grand Prix|Formula 1 Grand Prix|||
Formula One Grand Prix|Formula One Grand Prix|||
Fort Apache|Fort Apache|||
Foundation's Waste|Foundation's Waste|Foundation's Waste||
Four-F|Four-F|||
Fourmi Story|Fourmi Story|||
Fraction Action|Fraction Action|||
Frankenstein|Frankenstein|||
Frantick|Frantick|||
Freaked Out 2|Freaked Out 2|||
Freaked Out|Freaked Out|||
Freddy Hardest in South Manhattan|Freddy Hardest in South Manhattan|||
Fred|Fred|||
Free Climbing|Free Climbing|||
Freedom: Rebels in the Darkness|Freedom - Rebels in the Darkness|||
Frenetic|Frenetic|||
Frogger!|Frogger!|||
Froggy Day In London Town, A|Froggy Day In London Town, A|||
From Little Acorns|From Little Acorns|||
Frontier: Elite II|Frontier - Elite II|||
Frontline|Frontline|||
Frost Byte|Frost Byte|||
Fruit Machine|Fruit Machine|||
Full Count Baseball|Full Count Baseball|||
Full Metal Planete|Full Metal Planete|Full Metal Planete||
Fun School 2: For 6 to 8 Year Olds|Fun School 2 - For 6 to 8 Year Olds|||
Fun School 2: For the Over 8s|Fun School 2 - For the Over 8s|||
Fun School 2: For the Under 6s|Fun School 2 - For the Under 6s|||
Fun School 3: For the 5 to 7 Year Olds|Fun School 3 - For the 5 to 7 Year Olds|||
Fun School 3: for the over 7s|Fun School 3 - For the Over 7s|||
Fun School 3: For the Under 5s|Fun School 3 - For the Under 5s|||
Fun School 4: For 5 to 7 Year Olds|Fun School 4 - For 5 to 7 Year Olds|||
Fun School 4: For the 7 to 11 Year Olds|Fun School 4 - For the 7 to 11 Year Olds|||
Fun School 4: Under 5s|Fun School 4 - Under 5s|||
Fusion|Fusion|||
Future Basketball|Future Basketball|Future Basketball||
Future Bike|Future Bike|||
Future Sport|Future Sport|||
Future Wars: Time Travellers|Future Wars - Time Travellers|Future Wars - Time Travellers||
Fuzzball|Fuzzball|||
Galactic Conqueror|Galactic Conqueror|||
Galactic Empire|Galactic Empire|||
Galaxian|Galaxian|||
Galaxy Force II|Galaxy Force II|Galaxy Force II||
Galdregon's Domain|Galdregon's Domain|||
Game Over II|Game Over II|Game Over II||
Games '92, The: Espana|Games '92, The - Espana|||
Games, The: Summer Edition|Games, The - Summer Edition|||
Games, The: Winter Edition|Games, The - Winter Edition|||
Garfield: Big, Fat, Hairy Deal|Garfield - Big, Fat, Hairy Deal|||
Garfield: Winter's Tale|Garfield - Winter's Tale|||
Gary Lineker's Hot-Shot!|Gary Lineker's Hot-Shot!|||
Gary Lineker's Super Skills|Gary Lineker's Super Skills|||
Gateway|Gateway|||
Gato: WWII Submarine Simulator|Gato - WWII Submarine Simulator|||
Gauntlet|Gauntlet|||
Gauntlet II|Gauntlet II|||
Gauntlet III: The Final Quest|Gauntlet III - The Final Quest|||
Gazza II|Gazza II|||
Gazza's Super Soccer|Gazza's Super Soccer|Gazza's Super Soccer||
GBA Championship Basketball: Two on Two|GBA Championship Basketball - Two on Two|||
Geisha|Geisha|||
Gem AmiGo|Gem AmiGo|||
Gemini Wing|Gemini Wing|Gemini Wing||
Gems|Gems|||
Gemstone Legend|Gemstone Legend|||
Gem'X|Gem'X|||
General|General|||
Germ Crazy|Germ Crazy|||
Get Dexter 2|Get Dexter 2|||
Get Dexter||Get Dexter||
Gettysburg|Gettysburg|||
GFL Championship Football|GFL Championship Football|GFL Championship Football||
Ghost Battle|Ghost Battle|||
Ghostbusters II|Ghostbusters II|||
Ghost Chaser|Ghost Chaser|||
Ghosts 'n' Goblins|Ghosts 'n' Goblins|Ghosts 'n' Goblins||
Ghouls 'n' Ghosts|Ghouls 'n' Ghosts|Ghouls 'n' Ghosts||
Gilbert: Escape from Drill|Gilbert - Escape from Drill|||
Gin Rummy|Gin Rummy|||
Gladiators|Gladiators|||
Glad: Killing Impact|Glad - Killing Impact|||
Global Commander|Global Commander|||
G-Loc|G-Loc|||
G.Nius|G.Nius|||
Gnome Ranger 2: Ingrid's Back|Gnome Ranger 2 - Ingrid's Back|||
Gnome Ranger|Gnome Ranger|||
GNU Chess 4.0|GNU Chess 4.0|||
Gnuchess|Gnuchess|||
GNU Chess|GNU Chess|||
Goal!|Goal!|||
Gobang|Gobang|||
Gobliiins|Gobliiins|||
Gobliiins II|Gobliiins II|||
Go Board|Go Board|||
GodPey|GodPey|||
Gods|Gods|||
Goin' Down with the Captain|Goin' Down With The Captain|||
Golden Axe|Golden Axe|||
Golden Path|Golden Path|||
Gold of the Americas|Gold of the Americas|||
Gold of the Aztecs,The|Gold of the Aztecs,The|||
Gold of the Realm|Gold of the Realm|||
Goldrunner|Goldrunner|||
Goldrunner II|Goldrunner II|||
Goldrunner II: Scenery Disk 1|Goldrunner II - Scenery Disk 1|||
Goldrunner II: Scenery Disk 2|Goldrunner II - Scenery Disk 2|||
Gold Rush!|Gold Rush!|||
Go-Moku + Renju||Go-Moku + Renju||
Gone Fish'n|Gone Fish'n|||
Goofy's Railway Express|Goofy's Railway Express|Goofy's Railway Express||
Go Player|Go Player|||
Gorf's Laby|Gorf's Laby|||
GPPD|GPPD|||
Graeme Souness Soccer Manager|Graeme Souness Soccer Manager|||
Graeme Souness Vector Soccer|Graeme Souness Vector Soccer|||
Graffiti Man|Graffiti Man|||
Graham Gooch World Class Cricket|Graham Gooch World Class Cricket|||
Graham Taylor Soccer Challenge|Graham Taylor Soccer Challenge|||
Grandad 2: In Search of Sandwiches|Grandad 2 - In Search of Sandwiches|||
Grandad: The Quest for Holey Vest|Grandad - The Quest for Holey Vest|||
Grand Monster Slam|Grand Monster Slam|||
Grand Prix 500cc 2|Grand Prix 500cc 2|||
Grand Prix 500cc|Grand Prix 500cc|||
Grand Prix Master|Grand Prix Master|||
Grannies Garden|Grannies Garden|||
Gran-Prix|Gran-Prix|||
Grav 2|Grav 2|||
Grav|Grav|||
Gravity|Gravity|Gravity||
Great Battles 1789-1865|Great Battles 1789-1865|||
Great Courts 2|Great Courts 2|||
Great Courts|Great Courts|||
Great Napoleonic Battles|Great Napoleonic Battles|||
Greg Norman's Ulitmate Golf|Greg Norman's Ulitmate Golf|||
Gremlins 2: The New Batch|Gremlins 2 - The New Batch|||
Grey Seas, Grey Skies|Grey Seas, Grey Skies|||
Gridiron!|Gridiron!|||
Gridrunner|Gridrunner|||
Grimblood|Grimblood|||
Growth|Growth|Growth||
Guardian Angel||Guardian Angel||
Guardians|Guardians|||
Gunship|Gunship|||
Guy Spy|Guy Spy|||
Hacker 2|Hacker 2|||
Hacker|Hacker|||
Hacker II: The Doomsday Papers||Hacker II - The Doomsday Papers||
Hacman|Hacman|||
Hacman II|Hacman II|||
Hades Nebula|Hades Nebula|||
Hammer Boy|Hammer Boy|||
Hammerfist|Hammerfist|Hammerfist||
HangAbout!|HangAbout!|||
Hank's Quest: Victim of Society|Hank's Quest - Victim of Society|||
Happy Pacworm|Happy Pacworm|||
HardBall!|Hardball!|HardBall!||
Hard Drivin'|Hard Drivin'|||
Hard Drivin' II: Drive Harder|Hard Drivin' II - Drive Harder|||
Hard 'n' Heavy|Hard 'n' Heavy|||
Hard Nova|Hard Nova|Hard Nova||
Harlequin|Harlequin|||
Harley Davidson: The Road to Sturgis|Harley Davidson - The Road to Sturgis|||
Harley-Davidson: The Road to Sturgis||Harley-Davidson - The Road to Sturgis||
Harricana|Harricana|||
Harrier Strike Mission|Harrier Strike Mission|||
H.A.T.E|H.A.T.E|||
Haunted House|Haunted House|||
Hawkeye|Hawkeye|||
Hawkeye+|Hawkeye+|||
Head Coach|Head Coach|||
Head Long|Head Long|||
Head Over Heels|Head Over Heels|||
Heartland 2000|Heartland 2000|||
Heartland|Heartland|||
Heavy Metal|Heavy Metal|||
Hector vs the Mutant Vampire Tomatoes from Hell|Hector vs the Mutant Vampire Tomatoes from Hell|||
Heimdall|Heimdall|||
Hell Bent|Hell Bent|||
Hellfire|Hellfire|||
Hellraider|Hellraider|Hellraider||
Hell Raisers|Hell Raisers|||
Helter Skelter 1988|Helter Skelter 1988|||
Helter Skelter 1990|Helter Skelter 1990|||
Henrietta's Book of Spells|Henrietta's Book of Spells|||
Herman|Herman|||
H.E.R.O. 2|H.E.R.O. 2|||
Heroes of the Lance|Heroes of the Lance|||
Hero!|Hero!|||
H.E.R.O.|H.E.R.O.|||
Hero Quest|Hero Quest|||
Hero's Quest I: So You Want to be a Hero|Hero's Quest I - So You Want to be a Hero|||
Hex|Hex|||
High Steel|High Steel|||
Highway Encounter|Highway Encounter|||
Highway Patrol II|Highway Patrol II|||
Hillsfar|Hillsfar|||
Hill Street Blues|Hill Street Blues|Hill Street Blues||
Hippo Backgammon|Hippo Backgammon|||
H-Mec 2|H-Mec 2|||
H-Mec|H-Mec|||
Hockey Pista|Hockey Pista|||
Hole In One Golf|Hole In One Golf|||
Hollywood Hijinx|Hollywood Hijinx|||
Hollywood Hustler|Hollywood Hustler|||
Hollywood Poker|Hollywood Poker|||
Hollywood Poker Pro|Hollywood Poker Pro|||
Holocaust|Holocaust|||
Home Casino Poker|Home Casino Poker|||
Hong Kong Phooey|Hong Kong Phooey|||
Hook|Hook|||
Horror Zombies from the Crypt|Horror Zombies from the Crypt|||
Horse Racing Simulator|Horse Racing Simulator|||
Hostages|Hostages|Hostages||
Hotball|Hotball|||
Hot Rod|Hot Rod|||
Hot Rubber|Hot Rubber|||
Hotshot|Hotshot|Hotshot||
Hot Wheels|Hot Wheels|||
Hover Sprint|Hover Sprint|||
Hoyle Book of Games: Volume 1|Hoyle Book of Games - Volume 1|||
Hoyle Book of Games: Volume 2|Hoyle Book of Games - Volume 2|||
Huckleberry Hound in Hollywood Capers|Huckleberry Hound in Hollywood Capers|||
Hudson Hawk|Hudson Hawk|||
Human Killing Machine|Human Killing Machine|||
Hunchy 1066|Hunchy 1066|||
Hunchy 2010: 93 Remix|Hunchy 2010 - 93 Remix|||
Hunchy 2010|Hunchy 2010|||
Hunchy 2010: The Extended Mix|Hunchy 2010 - The Extended Mix|||
Hunter|Hunter|||
Hunter Killer|Hunter Killer|Hunter Killer||
Hunt for Grey November|Hunt for Grey November|||
Hustler|Hustler|||
Hydra|Hydra|||
Hyperbowl|Hyperbowl|Hyperbowl||
Hyperdrome|Hyperdrome|||
Hyperforce|Hyperforce|||
Hypnotic Land|Hypnotic Land|||
I, Ball|I, Ball|I, Ball||
IBS Guardian|IBS Guardian|||
IBS Pegasus|IBS Pegasus|||
IBS Starsearcher|IBS Starsearcher|||
Ice Hockey aka Face Off||Ice Hockey aka Face Off||
Ikari Warriors|Ikari Warriors|||
Illusion|Illusion|||
I Ludicrus|I Ludicrus|||
Impact!|Impact!|||
Imperium|Imperium|||
Impossamole|Impossamole|||
Impossible Mission II|Impossible Mission II|||
Impulse|Impulse|||
Indiana Jones and the Fate of Atlantis|Indiana Jones and the Fate of Atlantis|||
Indiana Jones and the Last Crusade: Arcade Game|Indiana Jones and the Last Crusade - Arcade Game|||
Indiana Jones and the Last Crusade|Indiana Jones and the Last Crusade|||
Indiana Jones and the Temple of Doom|Indiana Jones and the Temple of Doom|Indiana Jones and the Temple of Doom||
Indigo|Indigo|||
Indoor Sports|Indoor Sports|||
Indy 500|Indy 500|||
Indy Heat|Indy Heat|||
In Eighty Days Around the World|In Eighty Days Around the World|||
Inferno|Inferno|||
Infestation|Infestation|||
Infidel|Infidel|||
Ingrid's Back|Ingrid's Back|||
Insecticide|Insecticide|||
Insectroid|Insectroid|||
Insects in Space|Insects in Space|||
Inspector Hecti In The Inter Change|Inspector Hecti In The Inter Change|||
Interchange|Interchange|||
International 3D Tennis|International 3D Tennis|||
International Champion Athletics|International Champion Athletics|||
International Cricket 2|International Cricket 2|||
International Cricket|International Cricket|||
International Ice Hockey|International Ice Hockey|||
International Karate|International Karate|||
International Karate+|International Karate+|||
International Ninja Rabbits|International Ninja Rabbits|International Ninja Rabbits||
International Rugby Challenge|International Rugby Challenge|||
International Soccer Challenge|International Soccer Challenge|||
International Sports Challenge|International Sports Challenge|||
International Truck Racing|International Truck Racing|International Truck Racing||
Interphase|Interphase|Interphase||
Into the Eagle's Nest|Into the Eagle's Nest|||
Invaders|Invaders|||
Investigation 2|Investigation 2|||
Investigation|Investigation|||
I Play 3-D Soccer|I Play 3-D Soccer|||
Iron Lord|Iron Lord|||
Ironman Ivan Stewart's Super Off Road|Ironman Ivan Stewart's Super Off Road|||
Iron Trackers|Iron Trackers|||
Ishar III: The Seven Gates of Infinity|Ishar III - The Seven Gates of Infinity|||
Ishar II: Messengers of Doom|Ishar II - Messengers of Doom|||
Ishar: Legend of the Fortress|Ishar - Legend of the Fortress|||
Island Strike: The Ultimate Conflict|Island Strike - The Ultimate Conflict|||
ISS: Incredible Shrinking Sphere|ISS - Incredible Shrinking Sphere|||
Italy 1990|Italy 1990|Italy 1990||
Italy 1990: Winners Edition|Italy 1990 - Winners Edition|||
It's a Mug's Game|It's a Mug's Game|||
Ivanhoe|Ivanhoe|Ivanhoe||
Iznogoud|Iznogoud|||
Jack Nicklaus Greatest 18 Holes of Major Championship Golf|Jack Nicklaus Greatest 18 Holes of Major Championship Golf|||
Jaguar XJ220|Jaguar XJ220|||
Jahangir Khan's World Championship Squash|Jahangir Khan's World Championship Squash|||
James Pond II: Codename Robocod|James Pond II - Codename Robocod|||
James Pond II: CodeRoboCod||James Pond II - CodeRoboCod||
James Pond: Underwater Agent|James Pond - Underwater Agent|James Pond - Underwater Agent||
Jaws|Jaws|||
Jay Zebuland|Jay Zebuland|||
Jet|Jet|||
Jetpac|Jetpac|||
Jet Set Willy|Jet Set Willy|||
Jetsons|Jetsons|||
Jewels of Darkness|Jewels of Darkness|Jewels of Darkness||
Jiggsy|Jiggsy|||
Jigsaw Puzzlemania|Jigsaw Puzzlemania|||
Jimmy White's Whirlwind Snooker|Jimmy White's Whirlwind Snooker|||
Jim Power in Mutant Planet|Jim Power in Mutant Planet|||
Jinks|Jinks|||
Jinxter|Jinxter|||
Joan of Arc|Joan of Arc|||
Jocky Wilson's Darts|Jocky Wilson's Darts|||
Joe Blade 2|Joe Blade 2|||
Joe Blade|Joe Blade|||
John Barnes European Football|John Barnes European Football|||
John Lowe's Ultimate Darts|John Lowe's Ultimate Darts|||
Journey to the Center of the Earth|Journey to the Center of the Earth|||
Joust|Joust|||
Judge Dredd|Judge Dredd|||
Jug|Jug|||
Jumping Jack'Son|Jumping Jack'Son|||
Jump Jet|Jump Jet|||
Jumpster|Jumpster|||
Jungle Book|Jungle Book|||
Jungle Boy|Jungle Boy|||
Jungle Jim|Jungle Jim|||
Jupiter Probe|Jupiter Probe|||
Jupiter's Masterdrive|Jupiter's Masterdrive|||
Just Another War in Space|Just Another War in Space|||
Kaboom|Kaboom|||
Kamikaze|Kamikaze|||
Karateka|Karateka|||
Karting Grand Prix|Karting Grand Prix|||
Kayden Garth|Kayden Garth|||
Kelly X|Kelly X|||
Kennedy Approach|Kennedy Approach|||
Kenny Dalglish Soccer Manager|Kenny Dalglish Soccer Manager|||
Kev's World|Kev's World|||
Khalaan|Khalaan|||
Khephren|Khephren|||
Kick Off 2: Final Whistle|Kick Off 2 - Final Whistle|||
Kick Off 2|Kick Off 2|Kick Off 2||
Kick Off 2: Return to Europe|Kick Off 2 - Return to Europe|Kick Off 2 - Return to Europe||
Kick Off 2: The Final Whistle||Kick Off 2 - The Final Whistle||
Kick Off 2: Winning Tactics||Kick Off 2 - Winning Tactics||
Kick Off: Extra Time|Kick Off - Extra Time|||
Kick Off|Kick Off|||
Kid Gloves II|Kid Gloves II|||
Kid Gloves|Kid Gloves|||
Kid GP|Kid GP|||
Kid Kong|Kid Kong|||
Kids' Academy: Alvin's Puzzles|Kids' Academy - Alvin's Puzzles|||
Killdozers|Killdozers|||
Killerball|Killerball|||
Killer Chess|Killer Chess|||
Killing Machine|Killing Machine|||
Killing Time|Killing Time|||
Kill Tom|Kill Tom|||
Kingmaker|Kingmaker|||
King of Chicago|King of Chicago|||
King's Quest III: To Heir is Human||King's Quest III - To Heir is Human||
King's Quest III: To Heir is Human|King's Quest III - To Heir is Human|||
King's Quest II: Romancing the Throne|King's Quest II - Romancing The Throne|||
King's Quest IV: The Perils of Rosella|King's Quest IV - The Perils of Rosella|||
King's Quest: Quest for the Crown|King's Quest - Quest for the Crown|||
Klatrix|Klatrix|||
Klax|Klax|Klax||
Knicker Bockers|Knicker Bockers|||
Knight Force|Knight Force|||
Knightmare|Knightmare|||
Knight Orc|Knight Orc|||
Knights of the Sky|Knights of the Sky|||
Kosmic Krieg|Kosmic Krieg|||
Krypton Egg|Krypton Egg|||
Kubes|Kubes|||
Kult|Kult|||
Kwik Snax|Kwik Snax|||
Lancaster|Lancaster|||
Lancelot|Lancelot|||
Landmine|Landmine|||
Lands Of Havoc|Lands Of Havoc|||
Laser Squad|Laser Squad|Laser Squad||
Last Duel|Last Duel|||
Last Ninja 2|Last Ninja 2|||
Last Ninja 3|Last Ninja 3|Last Ninja 3||
Las Vegas|Las Vegas|||
Leader Board|Leader Board|Leader Board||
Leader Board: Tournament Disk I Enhanced|Leader Board - Tournament Disk I Enhanced|||
Leader Board: Tournament Disk I|Leader Board - Tournament Disk I|||
Leader Board Tournament||Leader Board Tournament||
League Challenge|League Challenge|||
Leander|Leander|||
Leather Goddesses of Phobos|Leather Goddesses of Phobos|||
Leatherneck|Leatherneck|||
Leavin' Teramis|Leavin' Teramis|||
Led Storm|Led Storm|||
Leeds United Champions|Leeds United Champions|||
Lee Enfield: An Amazon Adventure|Lee Enfield - An Amazon Adventure|||
Lee Enfield: Space Ace|Lee Enfield - Space Ace|||
Lee Enfield: The Tournament of Death|Lee Enfield - The Tournament of Death|||
Legend|Legend|||
Legend of Djel|Legend of Djel|||
Legend of Faerghail|Legend of Faerghail|||
Legend of the Lost|Legend of the Lost|||
Legend of the Sword|Legend of the Sword|||
Legends of Valour|Legends of Valour|||
Leisure Suit Larry 2: Goes Looking For Love|Leisure Suit Larry 2 - Goes Looking For Love|||
Leisure Suit Larry 3: Passionate Patti in Persuit of the Pulsating Pectorals|Leisure Suit Larry 3 - Passionate Patti in Persuit of the Pulsating Pectorals|||
Leisure Suit Larry in the Land of the Lounge Lizards|Leisure Suit Larry in the Land of the Lounge Lizards|||
Leisure Suit Larry in: The Land of the Lounge Lizards||Leisure Suit Larry in - The Land of the Lounge Lizards||
Lemmings 2: The Tribe|Lemmings 2 - The Tribe|||
Lemmings|Lemmings|||
Leonardo|Leonardo|||
Lethal Weapon|Lethal Weapon|||
Lethal Xcess: Wings of Death II|Lethal Xcess - Wings of Death II|Lethal Xcess - Wings of Death II||
Lettrix|Lettrix|||
Leviathan|Leviathan|||
Liberator|Liberator|||
Licence to Kill|Licence to Kill|||
Life and Death|Life and Death|||
Light Cycles|Light Cycles|||
Line Crash|Line Crash|||
Line of Fire|Line of Fire|||
Little Computer People|Little Computer People|||
Little Puff in Dragonland|Little Puff in Dragonland|||
Live and Let Die|Live and Let Die|||
Liverpool: The Computer Game|Liverpool - The Computer Game|||
Living Jigsaw|Living Jigsaw|||
Livingstone II|Livingstone II|||
Livingstone I Presume|Livingstone I Presume|||
Llamatron|Llamatron|||
Location Universe 2|Location Universe 2|||
Lock-On|Lock-On|||
Locomotion|Locomotion|Locomotion||
Lode Runner|Lode Runner|||
Logical|Logical|Logical||
Logic|Logic|||
Logo|Logo|||
Lombard Rally|Lombard Rally|||
Loom|Loom|||
Loopz|Loopz|||
Lord Ramsey in the 25th Century|Lord Ramsey in the 25th Century|||
Lords Of Chaos: Expansion Pack|Lords Of Chaos - Expansion Pack|||
Lords of Chaos|Lords Of Chaos|||
Lords of Conquest|Lords of Conquest|||
Lords of Doom|Lords of Doom|||
Lorna|Lorna|||
Lost Dutchman Mine|Lost Dutchman Mine|||
Lost Treasure|Lost Treasure|||
Lost World|Lost World|||
Lotus Esprit Turbo Challenge|Lotus Esprit Turbo Challenge|||
Lotus III: The Ultimate Challenge|Lotus III - The Ultimate Challenge|||
Lotus Turbo Challenge II|Lotus Turbo Challenge II|||
Lure of the Temptress|Lure of the Temptress|Lure of the Temptress||
Luxor|Luxor|||
M1 Tank Platoon|M1 Tank Platoon|||
Macadam Bumper|Macadam Bumper|||
Mach 3|Mach 3|Mach 3||
Mac Pan|Mac Pan|||
Macro War|Macro War|||
Mad Flunky|Mad Flunky|||
Mad Mix Game|Mad Mix Game|||
Mad Professor Mariarti|Mad Professor Mariarti|||
Mad Show|Mad Show|||
Mafdet and the Book of the Dead|Mafdet and the Book of the Dead|Mafdet and the Book of the Dead||
Magic Boy|Magic Boy|||
Magic Fly|Magic Fly|||
Magicland Dizzy|Magicland Dizzy|||
Magic Lines|Magic Lines|||
Magic Pocket|Magic Pocket|||
Magic Quest|Magic Quest|||
Magic Story Book|Magic Story Book|||
Major Motion|Major Motion|||
Makin' Whoopee|Makin' Whoopee|||
Maltese Joe's 3D Pool  Challenge|Maltese Joe's 3D Pool  Challenge|||
Manchester United Europe|Manchester United Europe|||
Manchester United|Manchester United|||
Manchester United: The Official Computer Game||Manchester United - The Official Computer Game||
Manhattan Dealers|Manhattan Dealers|Manhattan Dealers||
Manhunter 2: San Francisco|Manhunter 2 - San Francisco|||
Manhunter: New York|Manhunter - New York|||
Maniac Mansion|Maniac Mansion|||
Maniax|Maniax|||
Manix|Manix|||
Manoir de Mortevielle, Le||Manoir de Mortevielle, Le||
Marble Madness|Marble Madness|||
Margoulding, Le|Margoulding, Le|||
Maria's Christmas Box|Maria's Christmas Box|||
Masterblazer|Masterblazer|||
Masters of Chaos|Masters of Chaos|||
Masters of the Universe|Masters of the Universe|||
Mata Hari|Mata Hari|||
Match It!|Match It!|||
Match of the Day|Match of the Day|||
Maths Dragons|Maths Dragons|||
Matrix Marauders||Matrix Marauders||
Matrix Maruaders|Matrix Maruaders|||
Maupiti Island|Maupiti Island|||
Maya|Maya|||
Mayday Squad|Mayday Squad|||
Mazewar ST|Mazewar ST|||
McDonald Land|McDonald Land|||
Mean 18|Mean 18|Mean 18||
Mean Machine|Mean Machine|||
Mean Streets|Mean Streets|||
Medieval Chess|Medieval Chess|||
Mega lo Mania|Mega lo Mania|||
Mega Mines|Mega Mines|||
Mega Phoenix|Mega Phoenix|||
Megaroids|Megaroids|||
MegaTraveller|MegaTraveller|||
Megatrix|Megatrix|||
Mega Twins|Mega Twins|Mega Twins||
Menace|Menace|||
Mercenary: Escape From Targ|Mercenary - Escape From Targ|||
Mercenary: Escape from Targ & The Second City||Mercenary - Escape from Targ & The Second City||
Mercenary II: Damocles|Mercenary II - Damocles|||
Mercenary II: Damocles: Mission Disk 1|Mercenary II - Damocles - Mission Disk 1|||
Mercenary II: Damocles: Mission Disk 2|Mercenary II - Damocles - Mission Disk 2|||
Mercenary III: The Dion Crisis|Mercenary III - The Dion Crisis|||
Mercenary: The Second City|Mercenary - The Second City|||
Merchant Colony|Merchant Colony|||
Mercs|Mercs|||
Metal Link|Metal Link|||
Metal Masters|Metal Masters|||
Metal Mutant|Metal Mutant|||
Metro-Cross|Metro-Cross|Metro-Cross||
Metropolis|Metropolis|||
MGT: Magnetik Tank|MGT - Magnetik Tank|||
Miami Vice|Miami Vice|||
Michigan Mike and the Lost City of Zorog|Michigan Mike and the Lost City of Zorog|||
Mickey Mouse|Mickey Mouse|||
Mickey's Runaway Zoo|Mickey's Runaway Zoo|||
Micro League Baseball|Micro League Baseball|||
Micro League Wrestling|Micro League Wrestling|||
Microprose Formula One Grand Prix|Microprose Formula One Grand Prix|||
Microprose Golf|Microprose Golf|||
Microprose Soccer|Microprose Soccer|||
MidiBattle|MidiBattle|||
Midi Maze III|Midi Maze III|||
Midi Maze II|Midi Maze II|||
Midi Maze|Midi Maze|||
Midi Maze Plus|Midi Maze Plus|||
Midnight Resistance|Midnight Resistance|||
Midwinter II: Flames of Freedom|Midwinter II - Flames of Freedom|||
Midwinter|Midwinter|||
MIG 29 Fulcrum|MIG 29 Fulcrum|||
MIG 29M Super Fulcrum|MIG 29M Super Fulcrum|||
MIG 29 Soviet Fighter|MIG 29 Soviet Fighter|||
Mighty Bombjack|Mighty Bombjack|||
Mike Read's Computer Pop Quiz|Mike Read's Computer Pop Quiz|||
Mike Read's Pop Quiz|Mike Read's Pop Quiz|||
Millenium|Millenium|||
Millipede|Millipede|||
Milliways|Milliways|||
Mindbender|Mindbender|||
Mindfighter|Mindfighter|||
Mind Forever Voyaging, A|Mind Forever Voyaging, A|||
Mindshadow|Mindshadow|||
Mindwheel|Mindwheel|Mindwheel||
Minefield|Minefield|||
Mini Golf|Mini Golf|||
Minos|Minos|||
Missile Command|Missile Command|||
Missing: One Droid|Missing - One Droid|Missing - One Droid||
Mission Elevator|Mission Elevator|||
Mission en Rafale|Mission en Rafale|||
Mission Genocide|Mission Genocide|Mission Genocide||
Mission|Mission|||
Mission Mouse|Mission Mouse|||
Mix and Match|Mix and Match|||
Mixed Up Mother Goose|Mixed Up Mother Goose|||
Mobsters City|Mobsters City|||
Moebius|Moebius|||
Monkey Business|Monkey Business|||
Monkeys & Balloons|Monkeys & Balloons|||
Monopoly|Monopoly|||
Monster Business|Monster Business|Monster Business||
Monty Python's Flying Circus|Monty Python's Flying Circus|||
Moonbase|Moonbase|||
Moon Blaster|Moon Blaster|||
Moonfall|Moonfall|||
Moonmist|Moonmist|||
Moon Patrol|Moon Patrol|||
Moonshine Racers|Moonshine Racers|||
Moonwalker: The Computer Game|Moonwalker - The Computer Game|||
Mortville Manor|Mortville Manor|||
MOT|Mot|||
Motorbike Madness|Motorbike Madness|||
Motorhead|Motorhead|||
Motor Massacre|Motor Massacre|||
Mouse Trap|Mouse Trap|||
Mouth Trap|Mouth Trap|||
Mr Boomer|Mr Boomer|||
Mr Dig|Mr Dig|||
Mr. Heli|Mr. Heli|||
Ms.Pac|Ms.Pac|||
Mudpies|Mudpies|||
Multi Pakman|Multi Pakman|||
Multi Player Soccer Manager|Multi Player Soccer Manager|||
Mummies Playtime|Mummies Playtime|||
Murder|Murder|||
Murder on the Atlantic|Murder on the Atlantic|||
Murders in Space|Murders in Space|||
Murders in Venice|Murders in Venice|||
Mushy Music|Mushy Music|||
Music Construction Set|Music Construction Set|||
Mutant|Mutant|||
Muzzy|Muzzy|||
Mysterious Adventures|Mysterious Adventures|||
Mystery of the Mummy|Mystery of the Mummy|||
Mystical|Mystical|||
Myth|Myth|||
'Nam 1965-1975|'Nam 1965-1975|||
Name|HyperList|NoIntro|TOSEC|ReDump
Napoleon I: The Campaigns 1805-1814|Napoleon I - The Campaigns 1805-1814|||
NARC|Narc|||
Narco Police|Narco Police|||
Nautilus|Nautilus|||
Navy Moves|Navy Moves|||
Navy Seals|Navy Seals|||
Nebulus|Nebulus|||
Necron Aptor Quest|Necron Aptor Quest|||
Neighbours|Neighbours|||
Nervana|Nervana|||
Netherworld|Netherworld|||
Never Mind|Never Mind|Never Mind||
Nicky Boom|Nicky Boom|||
Nicky II|Nicky II|||
Nigel Mansell's Grand Prix|Nigel Mansell's Grand Prix|||
Nigel Mansell's World Championship||Nigel Mansell's World Championship||
Nigel Mansell's World Championships|Nigel Mansell's World Championships|||
Nightbreed|Nightbreed|||
Nightbreed: The Interactive Movie|Nightbreed - The Interactive Movie|||
Nightdawn|Nightdawn|||
Night Hunter|Night Hunter|||
Night Raider|Night Raider|||
Night Shift|Night Shift|Night Shift||
Nightwalk|Nightwalk|||
Night Walk||Night Walk||
Nine Princes in Amber|Nine Princes in Amber|||
Ninja Mission|Ninja Mission|||
Ninja Rabbits|Ninja Rabbits|Ninja Rabbits||
Ninja Remix|Ninja Remix|||
Ninja Spirit|Ninja Spirit|||
Nishiran|Nishiran|||
Nitro Boost Challenge|Nitro Boost Challenge|Nitro Boost Challenge||
Nitro|Nitro|||
No Buddies Land|No Buddies Land|||
Noddy's Playtime|Noddy's Playtime|||
No Excuses|No Excuses|No Excuses||
No Exit|No Exit|||
No Name the Game|No Name the Game|||
Nord & Bert|Nord & Bert|||
North and South||North and South||
North & South|North & South|||
NorthStar|NorthStar|||
No Second Prize|No Second Prize|||
Nostram|Nostram|||
Not a Penny More, Not a Penny Less|Not a Penny More, Not a Penny Less|||
Nova|Nova|||
Numero 10|Numero 10|||
Obitus|Obitus|||
Obliterator|Obliterator|Obliterator||
Obsession|Obsession|||
Off Shore Warrior|Off Shore Warrior|||
Ogre|Ogre|||
Oh-no! More Lemmings|Oh-no! More Lemmings|||
Oh No! Not More Radioactive Mineshafts|Oh No! Not More Radioactive Mineshafts|||
Oids: Extra Galaxies 1|Oids - Extra Galaxies 1|||
Oids: Extra Galaxies 2|Oids - Extra Galaxies 2|||
Oids: Extra Galaxies 3|Oids - Extra Galaxies 3|||
Oids: Extra Galaxies 4|Oids - Extra Galaxies 4|||
Oids: Extra Galaxies 5|Oids - Extra Galaxies 5|||
Oids: Extra Galaxies 6|Oids - Extra Galaxies 6|||
Oids: Extra Galaxies 7|Oids - Extra Galaxies 7|||
Oids: Extra Galaxies 8|Oids - Extra Galaxies 8|||
Oids|Oids|||
Oil Imperium|Oil Imperium|||
Oilmania|Oilmania|||
Oliver and Company|Oliver and Company|||
Olympus|Olympus|||
Omar Sharif's Bridge|Omar Sharif's Bridge|||
Omega|Omega|||
Omnicron Conspiracy|Omnicron Conspiracy|||
Once Upon A Time: Abracadabra|Once Upon a Time - Abracadabra|||
Once Upon a Time: Baba Yaga|Once Upon A Time - Baba Yaga|||
One Step Beyond|One Step Beyond|||
Onslaught|Onslaught|||
Oo-Topos|Oo-Topos|||
Ooze|Ooze|||
Operation Cleanstreets|Operation Cleanstreets|||
Operation Garfield|Operation Garfield|||
Operation Harrier|Operation Harrier|Operation Harrier||
Operation Hormuz|Operation Hormuz|||
Operation Jupiter|Operation Jupiter|||
Operation Stealth|Operation Stealth|Operation Stealth||
Operation Thunderbolt|Operation Thunderbolt|Operation Thunderbolt||
Operation Wolf|Operation Wolf|||
Orbit 2000|Orbit 2000|Orbit 2000||
Orbital Destroyer|Orbital Destroyer|||
Orbiter|Orbiter|||
Orbit|Orbit|||
Oriental Games|Oriental Games|Oriental Games||
Orion's Run|Orion's Run|||
Ork|Ork|||
Othello Killer|Othello Killer|||
Other Place|Other Place|||
Out Board|Out Board|||
Outcast|Outcast|Outcast||
Outer Limits|Outer Limits|||
Outguard|Outguard|||
Outlands|Outlands|||
Outlaw|Outlaw|||
Outrider|Outrider|||
Out Run Europa|Out Run Europa|||
Out Run|Out Run|||
Outzone|Outzone|||
Overdrive|Overdrive|||
Overlander|Overlander|Overlander||
Overlord|Overlord|||
Oxxonian: Action Game|Oxxonian - Action Game|||
Oxxonian: Statergy Game|Oxxonian - Statergy Game|||
Oxyd 2|Oxyd 2|||
Oxyd Magnum|Oxyd Magnum|||
Oxyd|Oxyd|||
Ozone 2|Ozone 2|||
Ozone|Ozone|||
P-47 Thunderbolt|P-47 Thunderbolt|||
Pablo and the Gold of Montezuma|Pablo and the Gold of Montezuma|||
Pac Attack|Pac Attack|||
Pacific Island: Team Yankee II|Pacific Island - Team Yankee II|||
Pac-Land|Pac-Land|||
Pac-Mania|Pac-Mania|Pac-Mania||
Pacman on E's|Pacman on E's|||
Pacman|Pacman|||
Pacman ST|Pacman ST|||
Pac-Men|Pac-Men|||
Painter|Painter|||
Paintz|Paintz|||
Paladin|Paladin|||
Pandora|Pandora|Pandora||
Pang|Pang|||
Panza Kick Boxing|Panza Kick Boxing|||
Paperboy|Paperboy|Paperboy||
Paradroid '90|Paradroid '90|||
Paragliding|Paragliding|||
Parasol Stars|Parasol Stars|||
Paris Dakar 1990|Paris Dakar 1990|||
Passengers on the Wind 2||Passengers on the Wind 2||
Passengers on the Wind II|Passengers on the Wind II|||
Passengers on the Wind|Passengers on the Wind|||
Passing Shot|Passing Shot|||
Pegasus|Pegasus|||
Peggammon|Peggammon|||
Penguin|Penguin|||
Pengy|Pengy|||
Penta|Penta|||
Pepe's Garden|Pepe's Garden|||
Pepsi Challenge: Mad Mix Game|Pepsi Challenge - Mad Mix Game|||
Perfect Match|Perfect Match|||
Perry Mason- The Case of the Mandarin Murder|Perry Mason- The Case of the Mandarin Murder|||
Personal Nightmare|Personal Nightmare|||
Peter Beardsley's International Football|Peter Beardsley's International Football|||
Phantasie III: The Wrath of Nikademus|Phantasie III - The Wrath of Nikademus|||
Phantasie II|Phantasie II|||
Phantasie|Phantasie|||
Phantasm|Phantasm|||
Pharaoh III|Pharaoh III|Pharaoh III||
Pharaoh|Pharaoh|||
Phobia|Phobia|||
Phoenix|Phoenix|||
Photon Storm|Photon Storm|||
Pick'n Pile|Pick'n Pile|||
Pictionary|Pictionary|||
Pictionary: The Game of Quick Draw||Pictionary - The Game of Quick Draw||
Pinball Factory|Pinball Factory|||
Pinball Magic|Pinball Magic|||
Pinball Wizard|Pinball Wizard|||
Pink Panther|Pink Panther|||
Pinoche: Four Handed-Double Deck|Pinoche - Four Handed-Double Deck|||
Pipe Dream|Pipe Dream|||
Pipetris|Pipetris|||
Pirates of the Barbary Coast|Pirates of the Barbary Coast|Pirates of the Barbary Coast||
Pirates!|Pirates!|||
Pitfighter|Pitfighter|||
Pixie and Dixie|Pixie and Dixie|||
Plan 9 From Outer Space|Plan 9 from Outer Space|||
Planetfall|Planetfall|||
Planet of Lust|Planet of Lust|||
Plasma Ball|Plasma Ball|||
Platform Capers|Platform Capers|||
Platonix|Platonix|||
Platoon|Platoon|||
Player Manager|Player Manager|Player Manager||
Playhouse Strip Poker|Playhouse Strip Poker|||
Plotting|Plotting|||
Plundered Hearts|Plundered Hearts|||
Plutos|Plutos|||
Police Quest II|Police Quest II|||
Police Quest: In Pursuit of the Death Angel||Police Quest - In Pursuit of the Death Angel||
Police Quest|Police Quest|||
Pong 2000|Pong 2000|||
Pontoon|Pontoon|||
Pool|Pool|||
Pooz|Pooz|||
Popeye 2|Popeye 2|||
Popeye|Popeye|||
Pop Music Challenge|Pop Music Challenge|||
Pop!|Pop!|||
Populous II|Populous II|||
Populous|Populous|||
Populous: The Promised Lands||Populous - The Promised Lands||
Pop Up|Pop Up|||
Postman Pat III|Postman Pat III|||
Postman Pat|Postman Pat|||
Pothole II|Pothole II|||
Pothole Pete|Pothole Pete|||
Potsworth and Co.|Potsworth and Co.|||
Pouif Ouf|Pouif Ouf|||
Power Boat|Power Boat|||
Power Cut|Power Cut|||
Power Drift|Power Drift|||
Powerdrome|Powerdrome|||
PowerMonger|Powermonger|||
Powerplay: The Game of the Gods|Powerplay - The Game of the Gods|||
Power Struggle|Power Struggle|||
Power Up plus|Power Up Plus|||
Precipice|Precipice|||
Predator 2|Predator 2|||
Predator|Predator|||
Prehistoric Tale, A|Prehistoric Tale, A|||
Prehistorik|Prehistorik|||
Premier Manager 2|Premier Manager 2|||
Premier Manager|Premier Manager|||
Prensorium|Prensorium|||
Preschool KidProgs|Preschool KidProgs|||
President Elect: 1988 Edition|President Elect - 1988 Edition|||
President Is Missing|President Is Missing|||
Prime Time|Prime Time|||
Prince of Persia|Prince of Persia|||
Prince of the Yolkfolk|Prince of the Yolkfolk|||
Prince|Prince|Prince||
Prison|Prison|Prison||
Pro Boxing Simulator|Pro Boxing Simulator|||
Profe$$or Crap$|Profe$$or Crap$|||
Professional Football Masters|Professional Football Masters|||
ProFlight|Proflight|||
Prohibition|Prohibition|||
Project Neptune|Project Neptune|||
Project Purify|Project Purify|||
Projectyle|Projectyle|||
Prophecy I: The Viking Child|Prophecy I - The Viking Child|||
Pro Powerboat Simulator|Pro Powerboat Simulator|||
Pro Soccer 2190|Pro Soccer 2190|||
Protector|Protector|||
Pro Tennis Simulator|Pro Tennis Simulator|||
Psion Chess|Psion Chess|||
Psyborg|Psyborg|||
Psycho Blast|Psycho Blast|||
Psycho Pig 2|Psycho Pig 2|||
Psycho|Psycho|||
Pub Trivia Simulator|Pub Trivia Simulator|||
Puffy's Saga|Puffy's Saga|||
Punt II|Punt II|||
Purple Saturn Day|Purple Saturn Day|||
Pursuit to Earth|Pursuit to Earth|||
Push 'n' Shove|Push 'n' Shove|||
Pushover|Pushover|||
Puzzle Book Vol. 1|Puzzle Book Vol. 1|||
Puzzle Book Vol. 2|Puzzle Book Vol. 2|||
Puzzled|Puzzled|||
Puzzle Gallary|Puzzle Gallary|||
Puzzmania|Puzzmania|||
Puzznic|Puzznic|Puzznic||
Pyramax|Pyramax|||
Qatbol|Qatbol|||
Q-Ball|Q-Ball|||
Qin|Qin|||
Quadralien|Quadralien|||
Quadrel|Quadrel|||
Quartz|Quartz|||
Quasar|Quasar|||
Queen|Queen|||
Quest for Galaxia|Quest for Galaxia|||
Question of Sport, A|Question of Sport, A|||
Questprobe III: Fantastic Four|Questprobe III - Fantastic Four|||
Questprobe II: Spiderman|Questprobe II - Spiderman|||
Questron II|Questron II|||
Quink|Quink|Quink||
Quizam!|Quizam!|||
Rabbit Jump|Rabbit Jump|||
Race Drivin'|Race Drivin'|||
Radio Controlled Racer|Radio Controlled Racer|||
Raffles|Raffles|Raffles||
Railroad Tycoon|Railroad Tycoon|||
Rainbow Islands|Rainbow Islands|||
Rainbow Warrior|Rainbow Warrior|||
Rally Cross Challenge||Rally Cross Challenge||
Rally Cross|Rally Cross|||
Rambo III|Rambo III|||
Rampage|Rampage|||
Rampart|Rampart|||
Ranarama|Ranarama|||
Ranx|Ranx|||
Razrats|Razrats|||
RBI Baseball Two|RBI Baseball Two|||
RC Aerochopper|RC Aerochopper|||
Reach for the Skies|Reach for the Skies|||
Realistic Video Poker|Realistic Video Poker|||
Realm of the Trolls|Realm of the Trolls|||
Realms of Reality|Realms of Reality|||
Realms|Realms|||
Reasoning with Trolls|Reasoning with Trolls|||
Rebellion|Rebellion|||
Rebound|Rebound|||
Recoil|Recoil|||
Recovery|Recovery|||
Red Ace|Red Ace|||
Red Alert|Red Alert|||
Red Heat|Red Heat|Red Heat||
Red Lightning|Red Lightning|||
Red Storm Rising|Red Storm Rising|Red Storm Rising||
Reflection|Reflection|||
Reflex|Reflex|||
Renaissance I|Renaissance I|||
Renegade|Renegade|||
Resolution 101|Resolution 101|Resolution 101||
Return to Genesis|Return to Genesis|||
Revelation|Revelation|||
Revenge II: Revenge of the Mutant Camels II||Revenge II - Revenge of the Mutant Camels II||
Revenge of the Mutant Camels II|Revenge of the Mutant Camels II|||
Revenge of the Mutant Camels|Revenge of the Mutant Camels|||
Rick Dangerous II|Rick Dangerous II|||
Rick Dangerous|Rick Dangerous|||
Ringside|Ringside|||
Rings of Medusa II: The Return of Medusa|Rings of Medusa II - The Return of Medusa|||
Rings of Medusa|Rings of Medusa|||
Rings of Zilfin|Rings of Zilfin|||
Risk|Risk|||
Risky Woods|Risky Woods|||
River of No Return|River of No Return|||
Road Blasters|Road Blasters|||
Road Raider|Road Raider|||
Road Runner|Road Runner|||
Roadwar 2000|Roadwar 2000|||
Roadwar Europa|Roadwar Europa|||
Roadwars||Roadwars||
Road Wars|Road Wars|||
Robbo|Robbo|||
Robert in the Fire Factory|Robert in the Fire Factory|||
Robin Hood: Legend Quest|Robin Hood - Legend Quest|||
Robin Smith's International Cricket|Robin Smith's International Cricket|||
Robinson's Requiem|Robinson's Requiem|||
RoboCop 2|Robocop 2|||
RoboCop 3|Robocop 3|||
RoboCop|Robocop|RoboCop||
Robotron 2084|Robotron 2084|||
Robotz|Robotz|||
Robozone|Robozone|||
Rocket Defense|Rocket Defense|||
Rocket Racer|Rocket Racer|||
Rocket Ranger|Rocket Ranger|||
Rockfall 2: The Perils of Spud|Rockfall 2 - The Perils Of Spud|||
Rockfall III: Rock Hard|Rockfall III - Rock Hard|||
Rockfall: Special Edition|Rockfall - Special Edition|||
Rockford|Rockford|||
Rock'n'Roll Clams|Rock'n'Roll Clams|||
Rock'n Roll|Rock'n Roll|||
Rock Star Ate My Hamster|Rock Star Ate My Hamster|Rock Star Ate My Hamster||
Rod-Land|Rod-Land|||
Rody et Mastico III||Rody et Mastico III||
Roger|Roger|||
Rogue II: Return to the Dungeon|Rogue II - Return to the Dungeon|||
Rogue|Rogue|||
Rogue Trooper|Rogue Trooper|||
Roller Coaster Rumbler|Roller Coaster Rumbler|||
Rolling Ronny|Rolling Ronny|||
Rolling Thunder|Rolling Thunder|||
Roll It|Roll It|||
Rollout|Rollout|||
Rorkes Drift|Rorkes Drift|||
Rosemary Raccoon's Strip Game|Rosemary Raccoon's Strip Game|||
Rotatus|Rotatus|||
Rotor|Rotor|Rotor||
Rotox|Rotox|||
Roulette|Roulette|||
Round the Bend|Round the Bend|||
Roy of the Rovers|Roy of the Rovers|||
R-Type II|R-Type II|||
R-Type|R-Type|||
Rubicon|Rubicon|||
Rude Llamatron|Rude Llamatron|||
Ruff and Reddy in the Space Adventure|Ruff and Reddy in the Space Adventure|||
Rugby Coach|Rugby Coach|||
Rugby League Boss|Rugby League Boss|||
Rugby League Coach|Rugby League Coach|||
Rugby: The World Cup|Rugby - The World Cup|||
Rumbo|Rumbo|||
Runaway|Runaway|||
Runner's Revenge|Runner's Revenge|||
Run the Gauntlet|Run the Gauntlet|||
Rush II|Rush II|||
Rush|Rush|||
Ruthless II|Ruthless II|||
Ruthless|Ruthless|||
RVF Honda|RVF Honda|||
R-Zone 2|R-Zone 2|||
R-Zone|R-Zone|||
Sabotage|Sabotage|||
Sabre Team|Sabre Team|||
Safari Guns|Safari Guns|||
Saint Dragon|Saint Dragon|||
Saint & Greavsie|Saint & Greavsie|||
Samurai: The Way of the Warrior|Samurai - The Way of the Warrior|||
Santa Paravia and Fiumaccio|Santa Paravia and Fiumaccio|||
Sapiens|Sapiens|||
Sarakon|Sarakon|||
Sargon III|Sargon III|Sargon III||
SAS Combat Simulator|SAS Combat Simulator|SAS Combat Simulator||
Satan|Satan|||
Savage|Savage|||
Scapeghost|Scapeghost|||
Scooby Doo and Scrappy|Scooby Doo and Scrappy|||
Scott Adams Adventures|Scott Adams Adventures|||
Scrabble Deluxe|Scrabble Deluxe|||
Scrabble|Scrabble|||
Scramble Spirits|Scramble Spirits|||
Screaming Wings|Screaming Wings|||
Scruples: A Question of|Scruples - A Question of|||
S.D.I.|S.D.I.|||
Seastalker|Seastalker|||
Sea Wolf|Sea Wolf|||
Secession|Secession|||
Seconds Out|Seconds Out|||
Secret of Steel|Secret of Steel|||
Sensible Soccer 1992-93 Season Edition|Sensible Soccer 1992-93 Season Edition|||
Sensible Soccer International Edition|Sensible Soccer International Edition|||
Sensible Soccer|Sensible Soccer|||
Seven Galaxies|Seven Galaxies|||
Seventh Fleet|Seventh Fleet|||
Sex Vixens From Space|Sex Vixens from Space|||
Seymour Goes to Hollywood|Seymour Goes To Hollywood|||
Shackled|Shackled|||
Shadow Dancer|Shadow Dancer|||
Shadowgate|Shadowgate|Shadowgate||
Shadowlands|Shadowlands|||
Shadow of the Beast II|Shadow of the Beast II|||
Shadow of the Beast|Shadow of the Beast|||
Shadoworlds|ShadoWorlds|||
Shadow Sorcerer|Shadow Sorcerer|||
Shadow Warriors|Shadow Warriors|||
Shanghai|Shanghai|||
Sharkey's Moll|Sharkey's Moll|||
Sheer Agony|Sheer Agony|||
She-Fox|She-Fox|||
Sherlock Holmes: The Riddle of the Crown Jewels|Sherlock Holmes - The Riddle of the Crown Jewels|||
Sherman M4|Sherman M4|||
Shiftrix|Shiftrix|||
Shinobi|Shinobi|||
Shocker 2: The House of Games|Shocker 2 - The House of Games|||
Shocker: Mad Martin's Revenge|Shocker - Mad Martin's Revenge|||
Shoot' em Up Construction Kit|Shoot' em Up Construction Kit|||
Shoot the Moon|Shoot the Moon|||
Shuffleboard|Shuffleboard|||
Shufflepuck Cafe|Shufflepuck Cafe|||
Shutdown|Shutdown|||
Shuttle: The Space Flight Simulator|Shuttle - The Space Flight Simulator|||
Side Arms|Side Arms|||
Sidewalk|Sidewalk|||
Sideways|Sideways|||
SideWinder II|SideWinder II|||
SideWinder|SideWinder|SideWinder||
Siegemaster|Siegemaster|||
Silent Service II|Silent Service II|||
Silent Service|Silent Service|||
Silicon Dreams|Silicon Dreams|||
Silkworm|Silkworm|Silkworm||
Silly Reels|Silly Reels|||
Sim City|Sim City|||
Simpsons, The: Bart vs the Space Mutants|Simpsons, The - Bart vs the Space Mutants|||
Simpsons, The: Bart vs the World|Simpsons, The - Bart vs the World|||
Simulcra|Simulcra|||
Sinbad and the Throne of the Falcon|Sinbad and the Throne of the Falcon|Sinbad and the Throne of the Falcon||
Skampy|Skampy|||
Skate Ball|Skate Ball|||
Skate Tribe|Skate Tribe|||
Skate Wars|Skate Wars|||
Skeet Shoot|Skeet Shoot|||
Skidoo|Skidoo|||
Skidz|Skidz|||
Skrull|Skrull|||
Skull and Crossbones|Skull and Crossbones|||
Skull Diggery|Skull Diggery|||
Skweek|Skweek|||
Sky Blaster|Sky Blaster|||
SkyChase|SkyChase|||
Sky Fighter|Sky Fighter|||
Skyfox II: The Cygnus Conflict|Skyfox II - The Cygnus Conflict|||
Skyfox|SkyFox|||
Sky High Stuntman|Sky High Stuntman|||
Skyrider|Skyrider|||
Skystrike Plus|Skystrike Plus|||
Sky Strike|Sky Strike|||
Slackskin & Flint|Slackskin & Flint|||
Slap Fight|Slap Fight|||
Slap N Tickle|Slap N Tickle|||
Slayer|Slayer|||
Slaygon|Slaygon|||
Sleeping Gods Lie|Sleeping Gods Lie|||
Sleepwalker|Sleepwalker|||
Sleuth|Sleuth|||
Sliders|Sliders|||
Slightly Magic|Slightly Magic|||
Slot Machine|Slot Machine|||
Slug|Slug|||
Sly Spy: Secret Agent|Sly Spy - Secret Agent|||
Smash Hit|Smash Hit|||
Smash TV|Smash TV|||
Snacman|Snacman|||
Snake Pit 2|Snake Pit 2|||
Snoball in Hell|Snoball in Hell|||
Snoofy|Snoofy|||
Snoopy and Peanuts|Snoopy and Peanuts|||
Snow Strike|Snow Strike|||
Soccer Glory|Soccer Glory|||
Soccer King|Soccer King|||
Soccer Manager Plus|Soccer Manager Plus|||
Soccer Supremo|Soccer Supremo|||
Soldier 2000|Soldier 2000|||
Soldier of Light|Soldier of Light|||
Solitaire Game Pak|Solitaire Game Pak|||
Sol Negro|Sol Negro|||
Solomon's Key|Solomon's Key|||
Sonic Boom|Sonic Boom|||
Son Shu Shi|Son Shu Shi|||
Sooty & Sweep|Sooty & Sweep|||
Sophelie|Sophelie|||
Sorcerer Lord|Sorcerer Lord|||
Sorcerer|Sorcerer|||
Sorcery +|Sorcery +|||
Space 1889|Space 1889|||
Space Ace II: Borf's Revenge|Space Ace II - Borf's Revenge|||
Space Ace|Space Ace|||
Space Baller|Space Baller|||
Spaceball|Spaceball|||
Space Conquest: A Galactic Odyssey|Space Conquest - A Galactic Odyssey|||
Space Crusade: The Voyage Beyond|Space Crusade - The Voyage Beyond|||
Space Cutter|Space Cutter|||
Space Fighter|Space Fighter|||
Space Gun|Space Gun|||
Space Harrier: Extra Levels|Space Harrier - Extra Levels|||
Space Harrier II|Space Harrier II|Space Harrier II||
Space Harrier Plus|Space Harrier Plus|||
Space Harrier|Space Harrier|Space Harrier||
Space Invaders|Space Invaders|||
Space Killer|Space Killer|||
Space Monsters|Space Monsters|||
Space Pilot|Space Pilot|||
Space Port|Space Port|||
Space Quest III: The Pirates of Pestulon|Space Quest III - The Pirates of Pestulon|||
Space Quest II: Vohaul's Revenge|Space Quest II - Vohaul's Revenge|||
Space Quest: The Serien Encounter|Space Quest - The Serien Encounter|||
Space Racer|Space Racer|||
Space Rogue|Space Rogue|||
Space Shuttle|Space Shuttle|||
Space Station Oblivion|Space Station Oblivion|||
Space Station|Space Station|||
Space War|Space War|||
Space War: The Next Generation|Space War - The Next Generation|||
Spacola|Spacola|||
Special Forces|Special Forces|||
Speedball 2: Brutal Deluxe|Speedball 2 - Brutal Deluxe|||
Speedball|Speedball|||
Speedboat Assassin|Speedboat Assassin|||
Speedy Joe|Speedy Joe|||
Spellbound Dizzy|Spellbound Dizzy|||
Spellbound!|Spellbound!|||
Spell Bound|Spell Bound|||
Spellbreaker|Spellbreaker|||
Spellfire The Sorceror|Spellfire The Sorceror|||
Spherical|Spherical|Spherical||
Spidertronic|Spidertronic|Spidertronic||
Spikey in Transylvania|Spikey in Transylvania|||
Spindizzy Worlds|Spindizzy Worlds|||
Spirit of Excalibur|Spirit of Excalibur|||
Spitfire 40|Spitfire 40|Spitfire 40||
Spitting Image|Spitting Image|Spitting Image||
Spook|Spook|||
Sporting Triangles|Sporting Triangles|||
Spot|Spot|||
Spot The Difference|Spot The Difference|||
Spy Snatcher|Spy Snatcher|||
Spy vs Spy 2: The Island Capers|Spy vs Spy 2 - The Island Capers|||
Spy vs Spy 3: Arctic Antics|Spy vs Spy 3 - Arctic Antics|||
Spy vs Spy|Spy vs Spy|||
Square Off|Square Off|||
Squish|Squish|||
Stable Masters II|Stable Masters II|||
Stack Up|Stack Up|||
STAC: The ST Adventure Creator|STAC - The ST Adventure Creator|||
Staff X-29|Staff X-29|||
STAG|STAG|||
Stalingrad Campaign|Stalingrad Campaign|||
Starball|Starball|||
StarBlade|Starblade|||
Starblaze|Starblaze|Starblaze||
Star Breaker|Star Breaker|||
Star Command|Star Command|||
Starcross|Starcross|||
Stardust|Stardust|||
Star Fleet I: The Battle Begins|Star Fleet I - The Battle Begins|||
Starflight|Starflight|StarFlight||
Starglider 2|Starglider 2|Starglider 2||
Starglider|Starglider|Starglider||
Star Goose!|Star Goose!|||
Starhawk II|Starhawk II|||
Stario's Christmas|Stario's Christmas|||
Starquake II|Starquake II|||
Starquake|Starquake|Starquake||
Star Raiders|Star Raiders|||
StarRay|StarRay|||
Star Trash|Star Trash|||
Star Trek: The Next Generation|Star Trek - The Next Generation|||
Star Trek: The Rebel Universe|Star Trek - The Rebel Universe|||
Star Troopers|Star Troopers|||
Star Wars: Return of the Jedi|Star Wars - Return of the Jedi|Star Wars - Return of the Jedi||
Star Wars|Star Wars|||
Star Wars: The Empire Strikes Back|Star Wars - The Empire Strikes Back|Star Wars - The Empire Strikes Back||
Star Wrek|Star Wrek|Star Wrek||
Stationfall|Stationfall|||
Steel Empire|Steel Empire|||
Steel|Steel|Steel||
Steg|Steg|||
Steigar|Steigar|||
Stellar Crusade|Stellar Crusade|||
Stepke Black and White|Stepke Black and White|||
Steve Davis World Snooker|Steve Davis World Snooker|||
Steve McQueen Westphaser|Steve McQueen Westphaser|||
ST Invaders|ST Invaders|||
ST Karate|ST Karate|||
ST Krak|ST Krak|||
ST Lingo|ST Lingo|||
Stock Market|Stock Market|||
ST Olympiad|ST Olympiad|||
Stone Age|Stone Age|Stone Age||
Stone-Breaker|Stone-Breaker|||
Stone Cold Sober|Stone Cold Sober|||
Stormball|Stormball|||
Stormbringer|Stormbringer|||
Stormlord|Stormlord|||
Storm Master|Storm Master|Storm Master||
Stormtrooper|Stormtrooper|||
STOS: The Game Creator|STOS - The Game Creator|||
ST Poker Royale|ST Poker Royale|||
ST Pool|ST Pool|||
ST-Protector|ST-Protector|||
Strange War|Strange War|||
Stratego|Stratego|||
Street Fighter II|Street Fighter II|||
Street Fighter|Street Fighter|||
Street Gang|Street Gang|||
Street Hockey|Street Hockey|||
ST Review Invaders|ST Review Invaders|||
Strider II|Strider II|||
Strider|Strider|Strider||
Strikefleet|Strikefleet|||
Strike Force Harrier|Strike Force Harrier|||
Striker Manager|Striker Manager|||
Striker|Striker|||
Strike|Strike|Strike||
Strip Break Out|Strip Break Out|||
Strip Poker II|Strip Poker II|||
Strip Poker II+|Strip Poker II+|||
Strip Poker|Strip Poker|||
Strong Lines|Strong Lines|||
Stryx|Stryx|Stryx||
ST Soccer|ST Soccer|||
ST Sorry!|ST Sorry!|||
S.T.U.N. Runner|S.T.U.N. Runner|||
Stunt Car Racer|Stunt Car Racer|||
ST Vegas|ST Vegas|||
ST Wars|ST Wars|||
Sub Battle Simulator|Sub Battle Simulator|||
Subbuteo: The Computer Game|Subbuteo - The Computer Game|||
Substation: Extra Level Daziel|Substation - Extra Level Daziel|||
Substation: Extra Level Itosho|Substation - Extra Level Itosho|||
Substation|Substation|||
Summer Games|Summer Games|||
Summer Olympiad|Summer Olympiad|||
Sundog: Frozen Legacy|Sundog - Frozen Legacy|Sundog - Frozen Legacy||
Superbike Challenge|Superbike Challenge|||
Super Break-Out|Super Break-Out|||
Super Cars II|Super Cars II|||
Super Cars|Super Cars|||
Super Cauldron|Super Cauldron|||
Super Cycle|Super Cycle|||
Super Dark Pearl|Super Dark Pearl|||
SuperFly|SuperFly|||
Super Grand Prix|Super Grand Prix|||
Super Hang-On|Super Hang-On|||
Super Highway|Super Highway|||
Super Huey|Super Huey|||
Super League Soccer|Super League Soccer|||
Superman: The Man of Steel|Superman - The Man of Steel|||
Super Monaco GP|Super Monaco GP|||
Super Nova|Super Nova|||
Super Scramble Simulator|Super Scramble Simulator|||
Super Scramble|Super Scramble|||
Super Seymour Saves the Planet|Super Seymour Saves The Planet|||
Super Ski II|Super Ski II|||
Super Ski|Super Ski|||
Super Skweek|Super Skweek|||
Super Soccer Challenge|Super Soccer Challenge|||
Super Space Invaders|Super Space Invaders|||
Super Sprint|Super Sprint|||
Superstar Ice Hockey|Superstar Ice Hockey|||
Super Stario Land|Super Stario Land|||
Super Stuntman|Super Stuntman|||
Super Wonderboy in Monsterland|Super Wonderboy in Monsterland|||
Supremacy: Your Will Be Done|Supremacy - Your Will Be Done|||
Suspect|Suspect|||
Suspended|Suspended|||
Suspicious Cargo|Suspicious Cargo|||
Swap|Swap|Swap||
Swiftar|Swiftar|||
Switchblade II|Switchblade II|||
Switchblade|Switchblade|||
SWIV|SWIV|||
Sword and the Rose|Sword and the Rose|||
Sword of Kadash|Sword Of Kadash|||
System 4|System 4|||
Table Tennis Simulation|Table Tennis Simulation|||
Tactical Manager|Tactical Manager|||
Tai-Pan|Tai-Pan|Tai-Pan||
Talespin: The Grail|Talespin - The Grail|||
Tanglewood|Tanglewood|||
Tangram|Tangram|||
Tank Attack|Tank Attack|||
Tank Battle|Tank Battle|||
Targhan|Targhan|||
Tass Times in Tonetown|Tass Times in Tonetown|Tass Times in Tonetown||
Tau Ceti|Tau Ceti|Tau Ceti||
T-Bird|T-Bird|||
Team Suzuki|Team Suzuki|||
Team|Team|||
Team Yankee|Team Yankee|||
Techmate Chess|Techmate Chess|||
Technocop|Technocop|||
Tech|Tech|||
Tecnoballz|Tecnoballz|||
Teenage Mutant Hero Turtles: Coin Op|Teenage Mutant Hero Turtles - Coin Op|||
Teenage Mutant Hero Turtles|Teenage Mutant Hero Turtles|||
Teenage Mutant Ninja Turtles World Tour|Teenage Mutant Ninja Turtles World Tour|||
Teenage Queen|Teenage Queen|||
Tee Off|Tee Off|||
Telemark Warrior|Telemark Warrior|||
Tempest|Tempest|||
Temple of Apshai Trilogy|Temple of Apshai Trilogy|||
Tennis Cup II|Tennis Cup II|||
Tennis Cup|Tennis Cup|Tennis Cup||
Tennis|Tennis|||
Terminator II: Judgemant Day|Terminator II - Judgemant Day|||
Termodroid|Termodroid|||
Terramex|Terramex|Terramex||
Terra Nova|Terra Nova|||
Terrestrial Encounter|Terrestrial Encounter|||
Terrorpods|Terrorpods|||
Terry's Big Adventure|Terry's Big Adventure|||
Test Drive II: The Duel|Test Drive II - The Duel|||
Test Drive|Test Drive|Test Drive||
Tetra Quest|Tetra Quest|||
Tetris II Strikes Back|Tetris II Strikes Back|||
Tetris|Tetris|||
Thai Boxing|Thai Boxing|||
The 3D Construction Kit|3D Construction Kit, The|||
The Adventures of Quik & Silva|Adventures of Quik & Silva, The|||
The Adventures of Robin Hood||Adventures of Robin Hood, The||
The Adventures of Robin Hood|Adventures of Robin Hood, The|||
The Amazing Spiderman|Amazing Spiderman, The|||
The Ancient Art of War in the Skies|Ancient Art of War in the Skies, The|||
The Atari Planetarium|Atari Planetarium, The|||
Theatre of War|Theatre of War|||
The Ball Game|Ball Game, The|||
The Basket Manager|Basket Manager, The|||
The Bimbo Story|Bimbo Story, The|||
The Black Cauldron|Black Cauldron, The|||
The Blues Brothers|Blues Brothers, The|Blues Brothers, The||
The Carl Lewis Challenge|Carl Lewis Challenge, The|||
The Case of the Mixed-Up Shymer|Case of the Mixed-Up Shymer, The|||
The Chaos Engine|Chaos Engine, The|||
The Chessmaster 2000||Chessmaster 2000, The||
The Chessmaster 2000|Chessmaster 2000, The|||
The Chronicles of Omega|Chronicles of Omega, The|||
The Colonel's Bequest|Colonel's Bequest, The|||
The Corporation|Corporation, The|||
The Curse of RA|Curse of Ra, The|||
The Damonoid|Damonoid, The|||
The Deep|Deep, The|The Deep||
The Domes of Sha|Domes of Sha, The|||
The Enforcer|Enforcer, The|||
The Eye of Horus|Eye of Horus, The|||
The Final Battle|Final Battle, The|||
The Final Conflict|Final Conflict, The|||
The Final Day|Final Day, The|||
The First Samurai|First Samurai, The|||
The Fool's Errand|Fool's Errand, The|||
The Gambler|Gambler, The|||
The Glass Buttock of Tharg|Glass Buttock of Tharg, The|||
The Godfather|Godfather, The|||
The Grail|Grail, The|||
The Great Giana Sisters|Great Giana Sisters, The|||
The Guardian Angel|Guardian Angel, The|||
The Guild of Thieves|Guild of Thieves, The|Guild of Thieves, The||
The Hammer of Grimmold|Hammer of Grimmold, The|||
The Hitchhikers Guide to the Galaxy|Hitchhikers Guide to the Galaxy, The|||
The Hi-Tec Hanna-Barbera Cartoon Character Collection||Hi-Tec Hanna-Barbera Cartoon Character Collection, The||
The Hoog Islands|Hoog Islands, The|||
The Hound of Shadow|Hound of Shadow, The|Hound of Shadow, The||
The Hunt for Red October|Hunt for Red October, The|||
The Immortal|Immortal, The|The Immortal||
The Intruder|Intruder, The|||
Their Finest Hour: The Battle of Britain|Their Finest Hour - The Battle of Britain|||
The Jade Stone|Jade Stone, The|||
The Karate Kid: Part II|Karate Kid - Part II, The|||
The Killing Cloud|Killing Cloud, The|Killing Cloud, The||
The Killing Game Show|Killing Game Show, The|||
The Kristal|Kristal, The|||
The Last Ninja|Last Ninja, The|||
The Last Shoot-em Up|Last Shoot-em Up, The|||
The Last Trooper|Last Trooper, The|||
The Light Corridor||Light Corridor, The||
The Light Corridor|Light Corridor, The|||
The Lost Kingdom of Zkul|Lost Kingdom of Zkul, The|||
The Lost Patrol|Lost Patrol, The|||
The Lurking Horror|Lurking Horror, The|Lurking Horror, The||
The Magician|Magician, The|||
The Magic Shop|Magic Shop, The|||
The Man from the Council|Man from the Council, The|||
Theme Park Mystery||Theme Park Mystery||
Theme Park Mystery: Variations on a Theme|Theme Park Mystery - Variations on a Theme|||
The Munsters|Munsters, The|||
The Mystic Well|Mystic Well, The|||
The New Zealand Story|New Zealand Story, The|||
The Ninja Warriors|Ninja Warriors, The|||
The North Sea Inferno|North Sea Inferno, The|||
The Official Everton F.C. Intelligensia||Official Everton F.C. Intelligensia, The||
The Oxford Softworks Go Player||Oxford Softworks Go Player, The||
The Patrician|Patrician, The|||
The Pawn|Pawn, The|Pawn, The||
The Persian Gulf Inferno|Persian Gulf Inferno, The|||
The President is Missing||President is Missing, The||
The Punisher|Punisher, The|||
The Quest for the Time-Bird|Quest for the Time-Bird, The|||
The Real Ghostbusters|Real Ghostbusters, The|Real Ghostbusters, The||
The Rock Man|Rock Man, The|||
The Running Man|Running Man, The|||
The Secret Cave|Secret Cave, The|||
The Secret of Monkey Island|Secret of Monkey Island, The|||
The Sentinel|Sentinel, The|||
The Seven Gates of Jambala||Seven Gates of Jambala, The||
The Seven Gates of Jambala|Seven Gates of Jambala, The|||
The Shoe People|Shoe People, The|||
The Spy Who Loved Me|Spy Who Loved Me, The|||
The Teller|Teller, The|||
The Third Courier|Third Courier, The|||
The Three Musketeers|Three Musketeers, The|||
The Toyottes|Toyottes, The|||
The Ultimate Arena|Ultimate Arena, The|||
The Ultimate Casino Gambling Simulation|Ultimate Casino Gambling Simulation, The|||
The Ultimate Ride|Ultimate Ride, The|||
The Ultimate 'tris Game|Ultimate 'tris Game, The|||
The Universal Military Simulator|Universal Military Simulator, The|||
The Untouchables|Untouchables, The|Untouchables, The||
The Witness|Witness, The|||
Things to do with Words|Things to do with Words|||
Think 2|Think 2|||
Think Cross|Think Cross|||
Think|Think|||
Third Reich|Third Reich|||
Thomas the Tank Engine 2|Thomas the Tank Engine 2|||
Thomas the Tank Engine & Friends|Thomas the Tank Engine & Friends|||
Thrust|Thrust|Thrust||
Thunderbirds|Thunderbirds|||
Thunder Blade|Thunder Blade|||
Thunder Burner|Thunder Burner|Thunder Burner||
Thundercats|Thundercats|ThunderCats||
Thunderhawk AH-73M|Thunderhawk AH-73M|||
Thunder Jaws|Thunder Jaws|||
Thunderstrike|Thunderstrike|||
Thunderwing||ThunderWing||
Thunder Wing|Thunder Wing|||
Thurg-N-Murg|Thurg-N-Murg|||
Tiger Road|Tiger Road|||
Time and Magik|Time and Magik|Time and Magik||
Time Bandit|Time Bandit|||
Timeblast||Timeblast||
Time Blast|Time Blast|||
Time Machine|Time Machine|||
Time Race|Time Race|||
Time Runner|Time Runner|||
Time Scanner|Time Scanner|||
Times of Lore|Times of Lore|||
Time Soldier|Time Soldier|||
Time|Time|||
Tintin on the Moon|Tintin on the Moon|Tintin on the Moon||
Tiny Skweeks|Tiny Skweeks|||
Tip Off|Tip Off|||
Titanic Blinky|Titanic Blinky|||
Titan|Titan|||
Titus the Fox: To Marrakech and Back|Titus the Fox - To Marrakech and Back|||
TNT|TNT|||
To Be on Top|To Be on Top|||
Toki|Toki|||
Tolteka|Tolteka|||
Tom and the Ghost|Tom and the Ghost|||
Tom & Jerry: Hunting High and Low|Tom & Jerry - Hunting High and Low|||
Tom & Jerry|Tom & Jerry|||
Tomtar|Tomtar|||
Tonic Tile|Tonic Tile|||
Toobin|Toobin|||
Toobin'||Toobin'||
Top Banana|Top Banana|||
Top Cat Starring in Beverly Hills Cats||Top Cat Starring in Beverly Hills Cats||
Top Cat: Starring On Beverly Hills Cats|Top Cat - Starring On Beverly Hills Cats|||
Top Gun|Top Gun|||
Top Secret|Top Secret|||
Tornado Ground Attack|Tornado Ground Attack|||
Torvak the Warrior|Torvak the Warrior|||
Total Eclipse|Total Eclipse|||
Total Recall|Total Recall|||
Touring Car Racer|Touring Car Racer|||
Tournament Golf|Tournament Golf|||
Tower of Babel|Tower of Babel|Tower of Babel||
Towers|Towers|||
Tower Toppler|Tower Toppler|||
Toyota Celica GT Rally|Toyota Celica GT Rally|||
Trackball|Trackball|||
Tracker|Tracker|||
Tracksuit Manager|Tracksuit Manager|||
Trailblazer||Trailblazer||
Trail Blazer|Trail Blazer|||
Transartica|Transartica|||
Transputor|Transputor|||
Transylvania|Transylvania|||
Trantor|Trantor|||
Trap|Trap|||
Trash Heap|Trash Heap|Trash Heap||
Trauma|Trauma|Trauma||
Treasure Island Dizzy|Treasure Island Dizzy|||
Treasure Island|Treasure Island|||
Treasure Trap|Treasure Trap|||
Treble Champions II|Treble Champions II|||
Treble Champions|Treble Champions|Treble Champions||
Trex Warrior: 22nd Century Gladiator|Trex Warrior - 22nd Century Gladiator|||
Trifide|Trifide|||
Trinity|Trinity|Trinity||
Triton III|Triton III|||
Trivia Challenge|Trivia Challenge|||
Trivial Pursuit: A New Beginning|Trivial Pursuit - A New Beginning|Trivial Pursuit - A New Beginning||
Trivial Pursuit: Genus Edition|Trivial Pursuit - Genus Edition|||
Trivia Trove|Trivia Trove|||
Trolls|Trolls|||
Truck|Truck|||
Turbo Cup|Turbo Cup|||
Turbo GT|Turbo GT|Turbo GT||
Turbo OutRun|Turbo Outrun|Turbo OutRun||
Turbo ST|Turbo ST|||
Turn It|Turn It|||
Turn n' Burn|Turn N' Burn|||
Turrican II: The Final Fight||Turrican II - The Final Fight||
Turrican II|Turrican II|||
Turrican|Turrican|||
Turtle Table Tennis Simulator|Turtle Table Tennis Simulator|||
Tusker|Tusker|||
TV Sports Football|TV Sports Football|TV Sports Football||
Twilight's Ransom|Twilight's Ransom|||
Twin Turbos|Twin Turbos|||
TwinWorld: Land of Vision|Twinworld - Land of Vision|||
Twylyte|Twylyte|Twylyte||
Tymewarp|Tymewarp|||
Typhoon Thompson: In Search for the Sea Child|Typhoon Thompson - In Search for the Sea Child|||
Typhoon|Typhoon|||
Typing Tutor plus Word Invaders|Typing Tutor plus Word Invaders|||
Ultima III: Exodus|Ultima III - Exodus|||
Ultima II|Ultima II|||
Ultima IV: Quest of the Avatar|Ultima IV - Quest of the Avatar|||
Ultima VI: The False Prophet|Ultima VI - The False Prophet|||
Ultima V: Warriors of Destiny|Ultima V - Warriors of Destiny|||
UMS: The Universal Military Simulator||UMS - The Universal Military Simulator||
Under Pressure|Under Pressure|||
Under the Ice|Under the Ice|||
Uninvited|Uninvited|||
Universal Military Simulator 2, The: Nations at War|Universal Military Simulator 2, The - Nations at War|||
Universe 3|Universe 3|Universe 3||
Universe II|Universe II|||
Unreal|Unreal|||
UN Squadron|UN Squadron|||
Uridium|Uridium|||
U.S.S. John Young|U.S.S. John Young|||
Utopia: The Creation of a Nation|Utopia - The Creation of a Nation|||
Utopos|Utopos|||
Valgus 2|Valgus 2|||
Vampire's Empire|Vampire's Empire|||
Vaxine|Vaxine|||
Vectorball|Vectorball|Vectorball||
Vector Invasion|Vector Invasion|||
Vegas Craps|Vegas Craps|||
Vegas Gambler|Vegas Gambler|||
Vengeance of Excalibur|Vengeance of Excalibur|||
Venus: The Flytrap|Venus - The Flytrap|||
Verminator|Verminator|||
Veteran|Veteran|||
Victory Road|Victory Road|||
Victory|Victory|||
Videokid|Videokid|||
Video Vegas|Video Vegas|||
Vigilante|Vigilante|||
Viking III|Viking III|||
Vindicators|Vindicators|Vindicators||
Violator|Violator|||
Violence|Violence|||
Violent Death|Violent Death|||
Virus|Virus|Virus||
Vixen|Vixen|||
Viz|Viz|||
Volfied|Volfied|||
Volleyball Simulator|Volleyball Simulator|||
Voodoo Nightmare|Voodoo Nightmare|||
Voyager|Voyager|||
Vroom Multiplayer|Vroom Multiplayer|||
Vroom|Vroom|||
Vulcan: The Tunisian Campaing|Vulcan - The Tunisian Campaing|||
Wacky Darts|Wacky Darts|||
Wacky Races|Wacky Races|||
Walls of Illusion|Walls of Illusion|||
Walz|Walz|||
Wanderer 3D|Wanderer 3D|Wanderer 3D||
Wanderer|Wanderer|||
Wanted|Wanted|Wanted||
Wargame Construction Set|Wargame Construction Set|||
Warhawk|Warhawk|Warhawk||
Warhead|Warhead|||
War Heli|War Heli|||
War in Middle Earth|War in Middle Earth|War in Middle Earth||
War in the Gulf|War in the Gulf|||
Warlock's Quest|Warlock's Quest|Warlock's Quest||
Warlock: The Avenger|Warlock - The Avenger|||
Warlock|Warlock|Warlock||
War Machine|War Machine|||
Warp|Warp|||
Warriors of Reylene|Warriors of Reylene|||
Warship|Warship|||
War|War|||
War Zone|War Zone|||
Waterloo|Waterloo|||
Wayne Gretzky Hockey|Wayne Gretzky Hockey|||
Web of Terror|Web Of Terror|||
Ween: The Prophecy|Ween - The Prophecy|||
Weird Dreams|Weird Dreams|||
Well 'Ard|Well 'Ard|||
Welltris|Welltris|||
Werner ST|Werner ST|||
Western Games|Western Games|||
West Phaser|West Phaser|||
West|West|||
Where Time Stood Still|Where Time Stood Still|Where Time Stood Still||
Whiplash & Wagonwheel|Whiplash & Wagonwheel|||
Whipper-Snapper's Race|Whipper-Snapper's Race|||
Whirligig|Whirligig|Whirligig||
Whitewater Madness|Whitewater Madness|||
Who Framed Roger Rabbit|Who Framed Roger Rabbit|||
Wicked|Wicked|||
Wild Life|Wild Life|||
Wild Streets|Wild Streets|Wild Streets||
Wild Wheels|Wild Wheels|||
Willow|Willow|||
Window Wizard|Window Wizard|||
Windsurf Willy|Windsurf Willy|||
Windwalker|Windwalker|||
WingLord|WingLord|||
Wings of Death|Wings of Death|||
Winnie the Pooh in the Hundred Acre Wood|Winnie The Pooh In The Hundred Acre Wood|||
Winter Games|Winter Games|||
Winter Olympiad '88|Winter Olympiad '88|||
Winter Supersports|Winter Supersports|||
Wipe Out|Wipe Out|||
Wishbringer|Wishbringer|||
Wizard Royal|Wizard Royal|||
Wizard's Crown|Wizard's Crown|||
Wizard Warz|Wizard Warz|||
Wizball|Wizball|||
Wizkid: The Story of Wizball II|Wizkid - The Story of Wizball II|||
Wizmo|Wizmo|||
Wolfchild|Wolfchild|||
Wolfenstein 3D|Wolfenstein 3D|||
WolfPack|Wolfpack|||
Wonderland|Wonderland|||
Works Team Rally|Works Team Rally|||
World Championship Boxing Manager|World Championship Boxing Manager|World Championship Boxing Manager||
World Championship Soccer|World Championship Soccer|||
World Class Leader Board|World Class Leader Board|World Class Leader Board||
World Class Rugby: Five Nations Edition|World Class Rugby - Five Nations Edition|||
World Class Rugby|World Class Rugby|||
World Cricket|World Cricket|||
World Darts|World Darts|||
World Games|World Games|||
World League Soccer Manager|World League Soccer Manager|||
World of Henry|World of Henry|||
World Rugby|World Rugby|||
World Soccer|World Soccer|||
World Trophy Soccer|World Trophy Soccer|||
Wormhole I|Wormhole I|||
Wrangler|Wrangler|Wrangler||
Wrath of the Demon|Wrath of the Demon|||
Wreckers|Wreckers|||
WWF European Rampage Tour|WWF European Rampage Tour|||
WWF Wrestlemania|WWF Wrestlemania|||
Wyrd Ways|Wyrd Ways|||
X-Chess|X-Chess|||
Xe-bec|Xe-bec|||
Xenomorph|Xenomorph|||
Xenon 2: Megablast|Xenon 2 - Megablast|||
Xenon|Xenon|Xenon||
Xenophobe|Xenophobe|||
Xevious|Xevious|||
Xiphos|Xiphos|||
Xor|Xor|||
X-Out|X-Out|X-Out||
Xtron|Xtron|||
Xybots|Xybots|||
Yatzy|Yatzy|||
Ynis Witrin: Isle Of Glass|Ynis Witrin - Isle Of Glass|||
Yogi Bear & Friends in the Greed Monster|Yogi Bear & Friends in the Greed Monster|||
Yogi's Big Clean Up|Yogi's Big Clean Up|||
Yogi's Great Escape|Yogi's Great Escape|||
Yolanda|Yolanda|||
Yomo|Yomo|||
Zak McKracken and the Alien Mindbenders|Zak McKracken and the Alien Mindbenders|||
Zany Golf|Zany Golf|||
Zaptastic|Zaptastic|||
Zap|Zap|||
Zero 5|Zero 5|||
Zero Gravity|Zero Gravity|||
Zoltar|Zoltar|||
Zombie Apocalypse|Zombie Apocalypse|||
Zombi|Zombi|||
Zone Warrior|Zone Warrior|||
Zool|Zool|||
Zork III- The Dungeon Master|Zork III- The Dungeon Master|||
Zork II- The Wizard of Frobozz|Zork II- The Wizard of Frobozz|||
Zork I- The Great Underground Empire|Zork I- The Great Underground Empire|||
Zork: The Undiscovered Underground|Zork - The Undiscovered Underground|||
Z-Out|Z-Out|||
Zxym|Zxym|||
Zynaps|Zynaps|||
