10-Yard Fight|10-Yard Fight|10-Yard Fight|10-Yard Fight|
1942|1942|1942|1942|
1943: The Battle of Midway|1943 - The Battle of Midway|1943 - The Battle of Midway||
1991 Du Ma Racing|1991 Du Ma Racing|1991 Du Ma Racing|Du Ma Racing|
1999: Hore, Mita koto ka! Seikimatsu|1999 - Hore, Mitakotoka! Seikimatsu|1999 - Hore, Mitakotoka! Seikimatsu|1999 Hore, Mitakotoka! Seikimatsu|
3-D WorldRunner|3-D Battles of World Runner, The|3-D WorldRunner|3-D WorldRunner|
4 Nin Uchi Mahjong|4 Nin Uchi Mahjong|4 Nin Uchi Mahjong|4 Nin Uchi Mahjong|
6-in-1|6-in-1||6 in 1|
720°|720|720 Degrees|720 Degrees|
'89 Dennō Kyūsei Uranai|'89 Dennou Kyuusei Uranai|'89 Dennou Kyuusei Uranai|'89 Dennou Kyuusei Uranai|
8 Eyes|8 Eyes|8 Eyes|8 Eyes|
Aa Yakyū Jinsei Icchokusen|Aa Yakyuu Jinsei Icchokusen|Aa Yakyuu Jinsei Icchokusen|Aa Yakyuu Jinsei Icchokusen|
Abadox: The Deadly Inner War|Abadox - The Deadly Inner War|Abadox - The Deadly Inner War|Abadox - The Deadly Inner War|
Action 52|Action 52|Action 52|Action 52|
Advanced Dungeons & Dragons: Dragons of Flame|Advanced Dungeons & Dragons - Dragons of Flame|Advanced Dungeons & Dragons - Dragons of Flame||
Adventure Island 3||Adventure Island 3|Adventure Island 3|
Adventure Island|Adventure Island Classic Spanish|Adventure Island Classic|Adventure Island in the Pacific - Classic|
Adventure Island II||Adventure Island II|Adventure Island II|
Adventures of Dino-Riki|Adventures of Dino Riki, The|Adventures of Dino Riki|Adventures of DinoRiki|
Adventures of Lolo 2|Adventures of Lolo 2|Adventures of Lolo 2|Adventures of Lolo 2|
Adventures of Lolo 3|Adventures of Lolo 3|Adventures of Lolo 3|Adventures of Lolo 3|
Adventures of Lolo|Adventures of Lolo|Adventures of Lolo|Adventures of Lolo|
Adventures of Tom Sawyer|Adventures of Tom Sawyer|Adventures of Tom Sawyer|Adventures of Tom Sawyer|
After Burner|After Burner|After Burner|After Burner|
After Burner II|After Burner II||After Burner II|
Aigiina no Yogen: From The Legend of Balubalouk|Aigiina no Yogen - From The Legend of Balubalouk|Aigina no Yogen - Balubalouk no Densetsu Yori|Aigiina no Yogen - From The Legend of Balubalouk|
Air Fortress|Air Fortress|Air Fortress|Air Fortress|
Airwolf|Airwolf|Airwolf|Airwolf|
Ai Sensei no Oshiete: Watashi no Hoshi|Ai Sensei no Oshiete - Watashi no Hoshi|Ai Sensei no Oshiete - Watashi no Hoshi|Ai Sensei no Oshiete - Watashi no Hoshi|
Ai Senshi Nicol|Ai Senshi Nicol||Ai Senshi Nicol|
Akagawa Jirō no Yūrei Ressha|Akagawa Jirou no Yuurei Ressha|Akagawa Jirou no Yuurei Ressha|Akagawa Jirou no Yurei Ressha|
Akira|Akira|Akira|Akira|
Akumajō Dracula|Akumajou Densetsu|Akumajou Densetsu|Akumajou Densetsu|
Akumajō Special: Boku Dracula-kun!|Akumajou Special - Boku Dracula-kun|Akumajou Special - Boku Dracula-kun|Akumajou Special - Boku Dracula-kun|
Akuma-kun: Makai no Wana|Akuma-kun - Makai no Wana|Akuma-kun - Makai no Wana|Akuma-kun - Makai no Wana|
Alfred Chicken|Alfred Chicken|Alfred Chicken|Alfred Chicken|
Alien³|Alien 3|Alien 3|Alien 3|
Alien Syndrome|Alien Syndrome|Alien Syndrome|Alien Syndrome|
All Night Nippon Super Mario Bros.|All Night Nippon Super Mario Bros.||All Night Nippon SMB|
All-Pro Basketball|All-Pro Basketball|All-Pro Basketball|All-Pro Basketball|
Alpha Mission|Alpha Mission|Alpha Mission|Alpha Mission|
Al Unser Jr. Turbo Racing|Al Unser Jr. Turbo Racing|Al Unser Jr. Turbo Racing|Al Unser Jr. Turbo Racing|
Amagon|Amagon|Amagon|Amagon|
America Daitōryō Senkyo|America Daitouryou Senkyo|America Daitouryou Senkyo|America Daitouryou Senkyo|
American Dream|American Dream|American Dream|American Dream|
American Gladiators|American Gladiators|American Gladiators|American Gladiators|
America! Ōdan Ultra Quiz: Shijō Saidai no Tatakai|America Oudan Ultra Quiz - Shijou Saidai no Tatakai|America Oudan Ultra Quiz - Shijou Saidai no Tatakai|America Oudan Ultra Quiz - Shijou Saidai no Tatakai|
A Nightmare on Elm Street|Nightmare on Elm Street, A|Nightmare on Elm Street, A|Nightmare on Elm Street, A|
Ankoku Shinwa: Yamato Takeru Densetsu|Ankoku Shinwa - Yamato Takeru Densetsu|Ankoku Shinwa - Yamato Takeru Densetsu|Ankoku Shinwa - Yamato Takeru Densetsu|
Antarctic Adventure|Antarctic Adventure|||
Anticipation|Anticipation|Anticipation|Anticipation|
Archon: The Light and the Dark|Archon|Archon|Archon|
Arch Rivals: A Basket Brawl!|Arch Rivals - A BasketBrawl!|Arch Rivals - A Basketbrawl!|Arch-Rivals - A Basket Brawl!|
Arctic|Arctic|Arctic|Arctic|
A Ressha de Ikō|A Ressha de Ikou|A Ressha de Ikou|A Ressha de Ikou|
Argus|Argus|Argus|Argus|
Arkanoid|Arkanoid|Arkanoid|Arkanoid|
Arkanoid: Revenge of DOH|Arkanoid II|Arkanoid II|Arkanoid II|
Arkista's Ring|Arkista's Ring|Arkista's Ring|Arkista's Ring|
Armadillo|Armadillo|Armadillo|Armadillo|
Artelius|Artelius|Artelius|Artelius|
Asmik-kun Land|Asmik-kun Land|Asmik-kun Land|Asmik-kun Land|
Astérix|Asterix|Asterix|Asterix|
Astro Fang: Super Machine|Astro Fang - Super Machine|Astro Fang - Super Machine|Astro Fang - Super Machine|
Astro Robo Sasa|Astro Robo Sasa|Astro Robo Sasa|Astro Robo Sasa|
Astyanax|Astyanax|Astyanax|Astyanax|
Athena|Athena|Athena|Athena|
Athletic World|Athletic World|Athletic World|Athletic World|
Atlantis no Nazo|Atlantis no Nazo|Atlantis no Nazo|Atlantis no Nazo|
Attack Animal Gakuen|Attack Animal Gakuen|Attack Animal Gakuen|Attack Animal Gakuen|
Attack of the Killer Tomatoes|Attack of the Killer Tomatoes|Attack of the Killer Tomatoes|Attack of the Killer Tomatoes|
Aussie Rules Footy|Aussie Rules Footy|Aussie Rules Footy|Aussie Rules Footy|
Auto-Upturn |Auto-Upturn|Auto-Upturn|Auto-Upturn|
Babel no Tō|Babel no Tou|Babel no Tou|Babel no Tou|
Baby Boomer|Baby Boomer|Baby Boomer|Baby Boomer|
Back to the Future|Back to the Future|Back to the Future|Back to the Future|
Back to the Future Part II & III|Back to the Future Part II & III|Back to the Future Part II & III|Back to the Future part II & III|
Bad Dudes|Bad Dudes|Bad Dudes|Bad Dudes|
Bad News Baseball|Bad News Baseball|Bad News Baseball|Bad News Baseball|
Bad Street Brawler|Bad Street Brawler|Bad Street Brawler|Bad Street Brawler|
Bakushō!! Ai no Gekijō|Bakushou!! Ai no Gekijou|Bakushou!! Ai no Gekijou|Bakushou Ai no Gekijou|
Bakushō!! Jinsei Gekijō 2|Bakushou!! Jinsei Gekijou 2|Bakushou!! Jinsei Gekijou 2|Bakushou Jinsei Gekijou 2|
Bakushō!! Jinsei Gekijō 3|Bakushou!! Jinsei Gekijou 3|Bakushou!! Jinsei Gekijou 3|Bakushou Jinsei Gekijou 3|
Bakushō!! Jinsei Gekijō|Bakushou!! Jinsei Gekijou|Bakushou!! Jinsei Gekijou|Bakushou!! Jinsei Gekijou|
Bakushō! Star Monomane Shitennō|Bakushou! Star Monomane Shitennou|Bakushou! Star Monomane Shitennou|Bakushou! Star Monomane Shitennou|
Ballblazer|Ballblazer|Ballblazer|Ballblazer|
Balloon Fight|Balloon Fight|Balloon Fight|Balloon Fight|
Baltron|Baltron|Baltron|Baltron|
Banana|Banana|Banana|Banana|
Banana Prince|Banana Prince|Banana Prince|Banana Prince|
Bandai Golf: Challenge Pebble Beach|Bandai Golf - Challenge Pebble Beach|Bandai Golf - Challenge Pebble Beach|Bandai Golf - Challenge Pebble Beach|
Bandit Kings of Ancient China|Bandit Kings of Ancient China|Bandit Kings of Ancient China|Bandit Kings of Ancient China|
Barbie|Barbie|Barbie|Barbie|
Barker Bill's Trick Shooting|Barker Bill's Trick Shooting|Barker Bill's Trick Shooting|Barker Bill's Trick Shooting|
Baseball|Baseball|Baseball|Baseball|
Baseball Simulator 1.000|Baseball Simulator 1.000|Baseball Simulator 1.000|Baseball Simulator 1.000|
Baseball Stars 2|Baseball Stars II|Baseball Stars II||
Baseball Stars|Baseball Stars|Baseball Stars|Baseball Stars|
Bases Loaded 3|Bases Loaded 3|Bases Loaded 3|Bases Loaded 3|
Bases Loaded 4|Bases Loaded 4|Bases Loaded 4|Bases Loaded 4|
Bases Loaded|Bases Loaded|Bases Loaded|Bases Loaded Rev PRG2|
Bases Loaded|||Bases Loaded Rev PRG0|
Bases Loaded|||Bases Loaded Rev PRG1|
Bases Loaded II: Second Season|Bases Loaded II|Bases Loaded II - Second Season|Bases Loaded II - Second Season|
Base Wars: Cyber Stadium Series||Cyber Stadium Series - Base Wars|Cyber Stadium Series - Base Wars|
Batman: Return of the Joker|Batman - Return of the Joker|Batman - Return of the Joker|Batman - Return of the Joker|
Batman Returns|Batman Returns|Batman Returns|Batman Returns|
Batman: The Video Game||Batman - The Video Game|Batman - The Video Game|
Batsu & Terī|Batsu & Terii|Batsu & Terry - Makyou no Tetsujin Race|Batsu & Terry|
Battle Chess|Battle Chess|Battle Chess|Battle Chess|
Battle City|Battle City|Battle City|Battle City|
Battleship|Battleship|Battleship|Battleship|
Battletoads|Battletoads|Battletoads|Battletoads|
Battletoads & Double Dragon: The Ultimate Team|Battletoads & Double Dragon - The Ultimate Team|Battletoads-Double Dragon|Battletoads - Double Dragon|
Bee 52|Bee 52|Bee 52|Bee 52|
Beetlejuice|Beetlejuice|Beetlejuice|Beetlejuice|
Best of the Best Championship Karate|Best of the Best - Championship Karate|Best of the Best - Championship Karate|Best of the Best - Championship Karate|
Bible Adventures|Bible Adventures|Bible Adventures||
Bible Buffet|Bible Buffet|Bible Buffet||
Big Bird's Hide and Speak|Big Bird's Hide & Speak|Sesame Street - Big Bird's Hide & Speak||
Bigfoot|Bigfoot|Bigfoot|Bigfoot|
Big Nose Freaks Out|Big Nose Freaks Out|Big Nose Freaks Out|Big Nose Freaks Out|
Big Nose the Caveman|Big Nose the Caveman|Big Nose the Caveman|Big Nose the Caveman|
Bikkuriman World: Gekitō Sei Senshi|Bikkuriman World - Gekitou Sei Senshi|Bikkuriman World - Gekitou Sei Senshi|Bikkuriman World - Gekitou Sei Senshi|
Bill Elliott's NASCAR Challenge|Bill Elliott's NASCAR Challenge|Bill Elliott's NASCAR Challenge|Bill Elliott's NASCAR Challenge|
Bill & Ted's Excellent Video Game Adventure|Bill & Ted's Excellent Video Game Adventure|Bill & Ted's Excellent Video Game Adventure|Bill & Ted's Excellent Video Game Adventure|
Binary Land|Binary Land|Binary Land|Binary Land|
Bio Miracle Bokutte Upa|Bio Miracle Bokutte Upa|Bio Miracle Bokutte Upa|Bio Miracle Bokutte Upa|
Bionic Commando|Bionic Commando|Bionic Commando|Bionic Commando|
Bio-Senshi Dan: Increaser to no Tatakai|Bio Senshi Dan - Increaser Tono Tatakai|Bio Senshi Dan - Increaser Tono Tatakai|Bio Senshi Dan - Increaser Tono Tatakai|
Bird Week|Bird Week|Bird Week|Bird Week|
Blackjack|Blackjack|Blackjack||
Blades of Steel|Blades of Steel|Blades of Steel|Blades of Steel|
Blaster Master|Blaster Master|Blaster Master|Blaster Master|
Blodia Land: Puzzle Quest|Blodia Land - Puzzle Quest|Blodia Land - Puzzle Quest|Blodia Land - Puzzle Quest|
Bloody Warriors: Shan Go no Gyakushū|Bloody Warriors - Shan-Go no Gyakushuu|Bloody Warriors - Shan-Go no Gyakushuu|Bloody Warriors - Shan-Go no Gyakushuu|
Bo Jackson Baseball|Bo Jackson Baseball|Bo Jackson Baseball|Bo Jackson Baseball|
Bokosuka Wars|Bokosuka Wars|Bokosuka Wars|Bokosuka Wars|
Bomberman|Bomberman|Bomberman|Bomberman|
Bomberman II|Bomberman II|Bomberman II|Bomberman II|
Bonk's Adventure|Bonk's Adventure|Bonk's Adventure|Bonk's Adventure|
Name|GoodName|NoIntro|TOSEC|ReDump
Shatterhand|Shatterhand|Shatterhand|Shatterhand|
Sheng Huo Lie Zhuan|Sheng Huo Lie Zhuan|Sheng Huo Lie Zhuan|Sheng Huo Lie Zhuan|
Sherlock Holmes: Hakushaku Reijō Yūkai Jiken |Sherlock Holmes - Hakushaku Reijou Yuukai Jiken|Sherlock Holmes - Hakushaku Reijou Yuukai Jiken|Sherlock Holmes - Hakushaku Reijou Yuukai Jiken|
Tetris 2|Tetris 2|Tetris 2|Tetris 2|
The Addams Family: Pugsley's Scavenger Hunt|Addams Family, The - Pugsley's Scavenger Hunt|Addams Family, The - Pugsley's Scavenger Hunt|Addams Family, The - Pugsley's Scavenger Hunt|
The Bugs Bunny Birthday Blowout|Bugs Bunny Birthday Blowout, The|Bugs Bunny Birthday Blowout, The|Bugs Bunny Birthday Blowout, The|
The Bugs Bunny Crazy Castle|Bugs Bunny Crazy Castle, The|Bugs Bunny Crazy Castle, The|Bugs Bunny Crazy Castle, The|
The Penguin & Seal|Penguin & Seal, The|Penguin & Seal, The|Arctic Adventure - Penguin & Seal|
Turbo Racing|Turbo Racing|Turbo Racing|Turbo Racing|
Yoshi's Cookie|Yoshi's Cookie|Yoshi's Cookie|Yoshi's Cookie|
