3D Lunattack|3D Lunattack||3D Lunattack|
4D Romik Cube|4D Romik Cube|||
6809 Editor Assembler|6809 Editor Assembler|||
6809 Express|6809 Express|||
747 Flight Simulator|747 Flight Simulator|||
8 Ball Pool|8 Ball Pool|||
Adventure 2000|Adventure 2000|||
Adventure 2: Jerusalem|Adventure 2 - Jerusalem|||
Adventure 3: Williamsburg|Adventure 3 - Williamsburg|||
Adventure 4: Ultimate|Adventure 4 - Ultimate|||
Adventureland|Adventureland|||
Adventure Writer: Extended|Adventure Writer - Extended|||
Adventure Writer: Original|Adventure Writer - Original|||
Air Assault|Air Assault|||
Airball|Airball|||
Alcatraz|Alcatraz|||
Alien|Alien|||
Amazing|Amazing|||
Anagram Solver|Anagram Solver|||
And All Because|And All Because|||
Android Attack|Android Attack||Android Attack|
Anti Gravity|Anti Gravity|||
Aquanaut 471|Aquanaut 471|||
Arcadia|Arcadia|||
Astro Blast|Astro Blast|||
Athletyx|Athletyx|||
Atom Hunt|Atom Hunt|||
Attack|Attack|||
Backgammon|Backgammon|||
Backtrack|Backtrack|||
Balldozer|Balldozer|||
Bandit|Bandit|||
Bandito|Bandito|||
Barmy Burgers|Barmy Burgers||Barmy Burgers|
B.C.Bill|B.C.Bill|||
Beamrider|Beamrider|||
Beanstalker|Beanstalker|||
Big Characters|Big Characters|||
Black Jack|Black Jack|||
Black Sanctum|Black Sanctum|||
Blochead|Blochead|||
Blockbuster Quiz 2|Blockbuster Quiz 2|||
Blockbuster Quiz|Blockbuster Quiz|||
Bonka|Bonka||Bonka|
Bopswizzle|Bopswizzle|||
Boris the Bold|Boris the Bold|||
Boulder Crash 2 Plus|Boulder Crash 2 Plus|||
Brain Ache|Brain Ache|||
Bridge Master|Bridge Master|||
Brock's Kingdom|Brock's Kingdom|||
Bubble Buster|Bubble Buster|||
Bug Diver|Bug Diver|||
Bumpers|Bumpers|||
Bust Out!|Bust Out!|||
Buzzard Bait|Buzzard Bait|||
Buzz|Buzz|||
Buzzing Bertie|Buzzing Bertie|||
Canyon Climber|Canyon Climber|||
Capture the Flag!|Capture the Flag!|||
Car Simulator|Car Simulator|||
Cashman|Cashman|||
Cassette 50: Part 1|Cassette 50 - Part 1|||
Cassette 50: Part 2|Cassette 50 - Part 2|||
Cassette Insert Card Designer|Cassette Insert Card Designer|||
Catalyst|Catalyst|||
Catch Phrase|Catch Phrase|||
Cave Fighter|Cave Fighter|||
Caverns of Doom|Caverns of Doom|||
Cells & Serpents|Cells & Serpents|||
Centipede|Centipede|||
Chambers|Chambers|||
Champions!|Champions!|||
Championship Darts|Championship Darts|||
Chateau of Gold|Chateau of Gold|||
Chess|Chess|||
Christmas Eve|Christmas Eve|||
Chuckie Egg|Chuckie Egg|||
Chuckie Egg Plus|Chuckie Egg Plus|||
Circus Adventure|Circus Adventure|||
City Defence|City Defence|||
Clowns: Catching|Clowns - Catching|||
Clowns: Juggling|Clowns - Juggling|||
Color Golf|Color Golf|||
Color Invaders|Color Invaders|||
Color Planet Invasion|Color Planet Invasion|||
Color Space War|Color Space War|||
Colossal Cave|Colossal Cave|||
Combat Air Patrol|Combat Air Patrol|||
Computavoice|Computavoice|||
Computer Studies: Part 1|Computer Studies - Part 1|||
Computer Studies: Part 2|Computer Studies - Part 2|||
Computer Studies: Part 3|Computer Studies - Part 3|||
Computer Studies: Part 4|Computer Studies - Part 4|||
Convoy|Convoy|||
Copier|Copier|||
Copta Snatch|Copta Snatch|||
Cosmic Clones|Cosmic Clones|||
Cosmic Crusader|Cosmic Crusader|||
Cosmic Zap|Cosmic Zap|||
Cranky|Cranky|||
Crazy Foota 2|Crazy Foota 2|||
Crazy Foota|Crazy Foota|||
Crazy Painter|Crazy Painter|||
Cribbage|Cribbage|||
Cruising|Cruising|||
Crusader: An Arcade Adventure|Crusader - An Arcade Adventure|||
Cuber|Cuber|||
Cuthbert and the Golden Chalice|Cuthbert and the Golden Chalice|||
Cuthbert Goes Digging|Cuthbert Goes Digging|||
Cuthbert Goes Walkabout|Cuthbert Goes Walkabout|||
Cuthbert in Space|Cuthbert in Space|||
Cuthbert in the Cooler|Cuthbert in the Cooler|||
Cuthbert in the Jungle|Cuthbert in the Jungle|||
Cuthbert in the Mine|Cuthbert in the Mine|||
Cyclops|Cyclops|||
Cyrus|Cyrus|||
Dancing Devil|Dancing Devil|||
Danger Island|Danger Island|||
Danger Ranger|Danger Ranger|||
Database & Beat the Dragon|Database & Beat the Dragon|||
Database|Database|||
Datafall|Datafall|||
Datapen|Datapen|||
Dataplan|Dataplan|||
Death Cruise: 1 Player Version|Death Cruise - 1 Player Version|||
Death Cruise: 4 Player Version|Death Cruise - 4 Player Version|||
Death Valley|Death Valley|||
Defense|Defense|||
Delta Utility: Disk 2 Tape|Delta Utility - Disk 2 Tape|||
Delta Utility: File Address|Delta Utility - File Address|||
Demolition Derby|Demolition Derby|||
Demon Knight|Demon Knight|||
Desperado Dan|Desperado Dan|||
Detective|Detective|||
Devil Assault|Devil Assault|||
Diffuse|Diffuse|||
Dino Wars|Dino Wars|||
Dominoes|Dominoes|||
Donkey King|Donkey King|||
Doodle Bug|Doodle Bug|||
Downland|Downland|||
Draconian|Draconian|||
Dragbug|Dragbug|||
Dragon Chess|Dragon Chess|||
Dragon Composer|Dragon Composer|||
Dragon Darts|Dragon Darts|||
Dragon Fly 2|Dragon Fly 2|||
Dragon Fly|Dragon Fly|||
Dragon Fodder|Dragon Fodder|||
Dragon Golf|Dragon Golf|||
Dragon Hawk|Dragon Hawk|||
Dragon Invaders|Dragon Invaders|||
Dragon Mountain|Dragon Mountain|||
Dragon Selection No 1|Dragon Selection No 1|||
Dragon Selfrun|Dragon Selfrun|||
Dragon Slayer|Dragon Slayer|||
Dragon Trek|Dragon Trek|||
Dragon Utilities No 1|Dragon Utilities No 1|||
Dragrunner|Dragrunner|||
Drawezee|Drawezee|||
Dream Machine: Original|Dream Machine - Original|||
Dream Machine: Special|Dream Machine - Special|||
Drone Datatank|Drone Datatank|||
Dungeon Adventure|Dungeon Adventure|||
Dungeon Destiny|Dungeon Destiny|||
Dungeons of Death|Dungeons of Death|||
Dunkey Munkey|Dunkey Munkey|||
Earth Rescue|Earth Rescue|||
Eddie Steady Go!|Eddie Steady Go!|||
Editor Assembler Monitor Disassembler|Editor Assembler Monitor Disassembler|||
El Diablero|El Diablero|||
Electron|Electron|||
Electronic Author|Electronic Author|||
Empire|Empire|||
Enhanced Character Interpreter|Enhanced Character Interpreter|||
Escape|Escape|||
Everest|Everest|||
Execution|Execution|||
Face Maker|Face Maker|||
Family Accounts|Family Accounts|||
Family Address|Family Address|||
Family Banker|Family Banker|||
Family Budget|Family Budget|||
Fearless Freddy|Fearless Freddy|||
File Master|File Master|||
Fingers|Fingers|||
Fireball|Fireball|||
Fire Force|Fire Force|||
Fishy Business|Fishy Business|||
Flag!|Flag!|||
Flipper|Flipper|||
Folly Farm's Chicken Run|Folly Farm's Chicken Run|||
Football Manager|Football Manager|||
Formula 1|Formula 1|||
Frankie|Frankie|||
Franklin in Wonderland|Franklin in Wonderland|||
Franklin's Tomb|Franklin's Tomb|||
Free Parking: Monopoly|Free Parking - Monopoly|||
Frogger|Frogger|||
Fury|Fury|||
Galactic Ambush|Galactic Ambush|||
Galacticans|Galacticans|||
Galactic Gus|Galactic Gus|||
Galagon|Galagon|||
Galax Attax|Galax Attax|||
Galaxy Hitch Hike|Galaxy Hitch Hike|||
Galleons|Galleons|||
Ghost Attack|Ghost Attack|||
Giant's Castle|Giant's Castle|||
Girlfriend Adventure 2|Girlfriend Adventure 2|||
Gis-A-Job|Gis-A-Job|||
Glaxxons|Glaxxons|||
Gnome Adventure|Gnome Adventure|||
Go Fish!|Go Fish!|||
Golden Oldies 2: Various Utilities|Golden Oldies 2 - Various Utilities|||
Golden Voyage|Golden Voyage|||
Golf|Golf|||
Gordon Bennet|Gordon Bennet|||
Grabber|Grabber|||
Grand Prix|Grand Prix|||
Graphic Animator|Graphic Animator|||
Graphics System|Graphics System|||
Grid Runner|Grid Runner|||
Hacker Utilities|Hacker Utilities|||
Handicap Golf|Handicap Golf|||
Happy Birthday Dragon|Happy Birthday Dragon|||
Hareraiser: Finale|Hareraiser - Finale|||
Hareraiser: Prelude|Hareraiser - Prelude|||
Haunted House Adventure|Haunted House Adventure|||
Heimlich & Co|Heimlich & Co|||
Hide & Seek|Hide & Seek|||
Hilo|Hilo|||
Hole!|Hole!|||
Home Base|Home Base|||
Horace Goes Skiing|Horace Goes Skiing|||
Hornets|Hornets|||
Horse Race|Horse Race|||
Hotel on Mayfair: Game|Hotel on Mayfair - Game|||
Hotel on Mayfair: Instructions|Hotel on Mayfair - Instructions|||
Hunchback|Hunchback|||
Hungry Horace|Hungry Horace|||
Ice Castles|Ice Castles|||
Ice Master|Ice Master|||
I Ching|I Ching|||
Indoor Football|Indoor Football|||
Inlay Card Printer|Inlay Card Printer|||
Intergalactic Force|Intergalactic Force|||
Interplanetary Trader|Interplanetary Trader|||
Invader Cube: 3D OXO|Invader Cube - 3D OXO|||
Invader's Revenge|Invader's Revenge|||
Invoices and Statements: Editor|Invoices and Statements - Editor|||
Invoices and Statements: Viewer|Invoices and Statements - Viewer|||
Islands|Islands|||
Jet Boot Colin|Jet Boot Colin|||
Jet Set Willy|Jet Set Willy|||
Jet Set Willy Utility|Jet Set Willy Utility|||
Jigsaw|Jigsaw|||
Journey to the Centre of Phobos|Journey to the Centre of Phobos|||
Jukebox Demo|Jukebox Demo|||
Jump Jet|Jump Jet|||
Junior's Revenge|Junior's Revenge|||
Juxtaposition|Juxtaposition|||
Kamacarzy|Kamacarzy|||
Katerpillar Attack|Katerpillar Attack|||
Ket Trilogy, The: Final Mission|Ket Trilogy, The - Final Mission|||
Ket Trilogy, The: Mountains of Ket|Ket Trilogy, The - Mountains of Ket|||
Ket Trilogy, The: Temple of Vran|Ket Trilogy, The - Temple of Vran|||
Keys of the Wizard|Keys of the Wizard|||
King Cuthbert|King Cuthbert|||
King Tut|King Tut|||
Komet Kaze|Komet Kaze|||
Kriegspiel|Kriegspiel|||
Lancelot Adventure|Lancelot Adventure|||
Larkspur Waldorf: Is Trapped|Larkspur Waldorf - Is Trapped|||
Larkspur Waldorf: Journey Home|Larkspur Waldorf - Journey Home|||
Laser Attack|Laser Attack|||
Laser Run|Laser Run|||
Laser Zone|Laser Zone|||
Leggit!|Leggit!|||
Lion Heart|Lion Heart|||
Load It|Load It|||
Lord of the Dragons|Lord of the Dragons|||
Lost in Space|Lost in Space|||
Lucifer's Kingdom|Lucifer's Kingdom|||
Lunar Rover Patrol|Lunar Rover Patrol|||
MacDougal's Last Stand|MacDougal's Last Stand|||
Madness & Minotaur|Madness & Minotaur|||
Mandragore|Mandragore|||
Manic Miner|Manic Miner|||
Manic Miner Utility|Manic Miner Utility|||
Mansion of Doom|Mansion of Doom|||
Martian Crypt|Martian Crypt|||
Maurice Minor: Driver|Maurice Minor - Driver|||
Medicalc Spreadsheet|Medicalc Spreadsheet|||
Megamaze|Megamaze|||
Millipede|Millipede|||
Mined Out|Mined Out|||
Miser's Dream|Miser's Dream|||
Mission Attack|Mission Attack|||
Monster Maths|Monster Maths|||
Monsters & Magic|Monsters & Magic|||
Monsters|Monsters|||
Moon Cresta|Moon Cresta|||
Moon Hopper|Moon Hopper|||
Morbid Mansion|Morbid Mansion|||
Morocco Grand Prix|Morocco Grand Prix|||
Movie Producer|Movie Producer|||
Mr.Dig|Mr.Dig|||
Mudpies|Mudpies|||
Music Machine|Music Machine|||
Music Maestro|Music Maestro|||
Music Maker|Music Maker|||
Mysterious Adventures|Mysterious Adventures|||
Mystery of the Java Star Part 1|Mystery of the Java Star Part 1|||
Mystery of the Java Star Part 2|Mystery of the Java Star Part 2|||
Mystery of the Java Star Part 3|Mystery of the Java Star Part 3|||
Mystery of the Java Star Part 4|Mystery of the Java Star Part 4|||
Nad the Necromancer|Nad the Necromancer|||
Name|HyperList|NoIntro|TOSEC|ReDump
Nerble Force|Nerble Force|||
New Copy|New Copy|||
Night Driver|Night Driver|||
Night Flight|Night Flight|||
North Sea Oil|North Sea Oil|||
Noughts and Crosses|Noughts and Crosses|||
Nuclear Attack|Nuclear Attack|||
Number Chaser|Number Chaser|||
Number Gulper|Number Gulper|||
Number Puzzler|Number Puzzler|||
Oil Recovery|Oil Recovery|||
Onyton Adventure|Onyton Adventure|||
Ossie|Ossie|||
Othello|Othello|||
Pac Droids|Pac Droids|||
Password: Escape the Hangman|Password - Escape the Hangman|||
Pedro|Pedro|||
Pengammon|Pengammon|||
Pengon|Pengon|||
Perilous Pit|Perilous Pit|||
Perseus & Andromeda|Perseus & Andromeda|||
Pettigrew's Diary|Pettigrew's Diary|||
Photo Finish|Photo Finish|||
Picture Maker|Picture Maker|||
Picture Puzzler|Picture Puzzler|||
Pimania|Pimania|||
Pinball|Pinball|||
Pit Fiend|Pit Fiend|||
Pixel Editor|Pixel Editor|||
Pixel Writer Demo|Pixel Writer Demo|||
Pixel Writer|Pixel Writer|||
Poseidon Adventure|Poseidon Adventure|||
Printer Prompt|Printer Prompt|||
Programmer Utilities|Programmer Utilities|||
Project Volcano: Mission 1|Project Volcano - Mission 1|||
Pterodactyl|Pterodactyl|||
Pub Crawl|Pub Crawl|||
Pyradventure|Pyradventure|||
Pyramid of Doom|Pyramid of Doom|||
Quest|Quest|||
Racer Ball|Racer Ball|||
Raiders|Raiders|||
Rail Runner|Rail Runner|||
Rainbow Writer|Rainbow Writer|||
Red Alert|Red Alert|||
Red Meanies|Red Meanies|||
Rescue From Death's Head Hole|Rescue From Death's Head Hole|||
Return of the Jet-I|Return of the Jet-I|||
Robin Hood|Robin Hood|||
Robotron|Robotron|||
Rola Ball|Rola Ball|||
Roman Empire|Roman Empire|||
Rommel 3D|Rommel 3D|||
Rommel's Revenge|Rommel's Revenge|||
Rotabb|Rotabb|||
Row of Four|Row of Four|||
Ruby Robber|Ruby Robber|||
Russian Roulette|Russian Roulette|||
Save the Whale|Save the Whale|||
Scarfman|Scarfman|||
School Maze|School Maze|||
Script|Script|||
Sea Dragon|Sea Dragon|||
Secret Mission|Secret Mission|||
Seikosha Screen Dumper|Seikosha Screen Dumper|||
Sewer Rat|Sewer Rat|||
Shaft|Shaft|||
Shanghai|Shanghai|||
Shaolin Master Plus|Shaolin Master Plus|||
Shaolin Master|Shaolin Master|||
Shape Up|Shape Up|||
Shark Treasure|Shark Treasure|||
Shenanigans|Shenanigans|||
Shock Trooper|Shock Trooper|||
Short Basic Program|Short Basic Program|||
Show Jump|Show Jump|||
Shuffle|Shuffle|||
Shuttle Silo Satellite|Shuttle Silo Satellite|||
Shuttle Simulator|Shuttle Simulator|||
Simon Says|Simon Says|||
Skid Row|Skid Row|||
Skramble|Skramble|||
Slide|Slide|||
Sliding Picture Puzzles|Sliding Picture Puzzles|||
Smasher|Smasher|||
Snail Pace|Snail Pace|||
Snakes|Snakes|||
Sniper|Sniper|||
Solitaire|Solitaire|||
Solo Poker|Solo Poker|||
Space Fighter|Space Fighter|||
Space Invaders|Space Invaders|||
Space Monopoly|Space Monopoly|||
Space Race|Space Race|||
Space Raiders|Space Raiders|||
Space Trek 1: Disk Version|Space Trek 1 - Disk Version|||
Space Trek 1|Space Trek 1|||
Space Trek 2|Space Trek 2|||
Space Trek 3|Space Trek 3|||
Space Wrek|Space Wrek|||
Special Air Sevice|Special Air Sevice|||
Speed Racer|Speed Racer|||
Sporting Decathlon|Sporting Decathlon|||
Spreadsheet Program|Spreadsheet Program|||
Sprite Magic|Sprite Magic|||
Starfighter|Starfighter|||
Starman Jones|Starman Jones|||
Starship Chameleon|Starship Chameleon|||
Star Spores|Star Spores|||
Star Trek|Star Trek|||
Stockmarket|Stockmarket|||
Stone Raider II|Stone Raider II|||
Storm Arrows|Storm Arrows|||
Storm|Storm|||
Strategic Command|Strategic Command|||
Supa Nova|Supa Nova|||
Superkid|Superkid|||
Super Lander|Super Lander|||
Super Skill Hangman|Super Skill Hangman|||
Super Spy: Part 1|Super Spy - Part 1|||
Super Spy: Part 2|Super Spy - Part 2|||
Super Spy: Part 3|Super Spy - Part 3|||
Super Spy: Secret Mission|Super Spy - Secret Mission|||
Super Spy|Super Spy|||
Surprise|Surprise|||
Synther 7|Synther 7|||
Syzygy|Syzygy|||
Tape 2 Disk Transfer|Tape 2 Disk Transfer|||
Tape Copy|Tape Copy|||
Taskship|Taskship|||
Tele Forth: Programming Language|Tele Forth - Programming Language|||
Tele Mod: Tele Forth Addon|Tele Mod - Tele Forth Addon|||
Telewriter|Telewriter|||
Temple of Doom|Temple of Doom|||
Textstar|Textstar|||
The Bells|Bells, The|||
The Bomb|Bomb, The|||
The Chocolate Factory|Chocolate Factory, The|||
The Cricklewood Incident|Cricklewood Incident, The|||
The Dark Pit|Dark Pit, The|||
The Final Countdown|Final Countdown, The|||
The Fruity Machine|Fruity Machine, The|||
The Immortal Strain|Immortal Strain, The|||
The Keys of Roth|Keys of Roth, The|||
The Last Pirate|Last Pirate, The|||
The Master|Master, The|||
The Memory Builder|Memory Builder, The|||
The Phantom Slayer|Phantom Slayer, The|||
The Quest|Quest, The|||
The Ring of Darkness|Ring of Darkness, The|||
The Screaming Ab-Dabs|Screaming Ab-Dabs, The|||
The Thirteenth Task|Thirteenth Task, The|||
The Time Machine Search|Time Machine Search, The|||
The Trial of Arnold Blackwood|Trial of Arnold Blackwood, The|||
The White Barrows|White Barrows, The|||
Time Bandit|Time Bandit|||
Tim Love's Cricket|Tim Love's Cricket|||
Timscript|Timscript|||
Toppler|Toppler|||
Torpedo Run|Torpedo Run|||
Tosec Owns Us All|Tosec Owns Us All|||
Total Eclipse|Total Eclipse|||
Touch Typing Tutor|Touch Typing Tutor|||
Towers of Death & Ice Kingdom|Towers of Death & Ice Kingdom|||
Trace Race: 1 Player Version|Trace Race - 1 Player Version|||
Trace Race: 2 Player Version|Trace Race - 2 Player Version|||
Trace Racers|Trace Racers|||
Trader|Trader|||
Transylvanian Tower|Transylvanian Tower|||
Trap Fall|Trap Fall|||
Treasures of Barsoom|Treasures of Barsoom|||
Trekboer|Trekboer|||
Triplet|Triplet|||
Trivial Crosswords|Trivial Crosswords|||
Trojan Light Pen|Trojan Light Pen|||
Tron Light Cycles|Tron Light Cycles|||
Tropical Lanes|Tropical Lanes|||
Trun|Trun|||
Tube Way Army|Tube Way Army|||
Ugh!|Ugh!|||
Ultrapede|Ultrapede|||
Underbeings of Croth|Underbeings of Croth|||
Up Periscope|Up Periscope|||
UXB|UXB|||
Variable List|Variable List|||
Various for the Dragon 32|Various for the Dragon 32|||
Voodoo Castle|Voodoo Castle|||
Vortex Factor|Vortex Factor|||
Vulcanox|Vulcanox|||
Vultures|Vultures|||
Warlord|Warlord|||
War!|War!|||
Waxworks|Waxworks|||
Weetabix vs the Titchies|Weetabix vs the Titchies|||
Weirds of Kesh: Skulls & Bones|Weirds of Kesh - Skulls & Bones|||
Wheel of Fortune|Wheel of Fortune|||
Whirlybird Run|Whirlybird Run|||
Willy's Revenge|Willy's Revenge|||
Wipeout|Wipeout|||
Wizard's Lair|Wizard's Lair|||
Wizard's Quest|Wizard's Quest|||
Wizard War|Wizard War|||
Word Wise|Word Wise|||
World Boxing|World Boxing|||
World Cup Manager|World Cup Manager|||
Worlds of Flight|Worlds of Flight|||
Wumpus Mansion|Wumpus Mansion|||
Yumping Yosser|Yumping Yosser|||
Zak's Son|Zak's Son|||
Zaxxon|Zaxxon|||
Zorakk the Conqueror|Zorakk the Conqueror|||
Zotoka: Game|Zotoka - Game|||
Zotoka: Instructions|Zotoka - Instructions|||
