Anchorz Field|Anchor Field Z|Anchorz Field|Anchor Field 2|
Arc the Lad: Kijin Fukkatsu|Arc The Lad - Kijin Fukkatsu|||
Armored Unit|Armored Unit|Armored Unit|Armored Unit|
Bakusō Dekotora Densetsu|Bakusou Dekatora Densetsu|Bakusou Dekotora Densetsu for WonderSwan|Bakusou Dekotora Densetsu|
beatmania|Beat Mania|Beatmania for WonderSwan|Makaimura for WonderSwan|
Blue Wing Blitz|Blue Wing Blitz|||
BUFFERS EVOLUTION|Buffers Evolution|Buffers Evolution|Buffers Evolution|
Card Captor Sakura - Sakura to Fushigi na Clow Card|Card Captor Sakura - Sakura to Fushigi na Clow Card|Cardcaptor Sakura - Sakura to Fushigi na Clow Card|Cardcaptor Sakura - Sakura to Fushigi na Clow Card|
Chaos Gear Michibikareshi Mono|Chaos Gear - Michibi Kareshi Mono|Chaos Gear - Michibikareshi Mono|Chaos Gear - Michibikareshi Mono|
Chō Aniki: Otoko no Tamafuda |Chou Aniki - Otoko no Tamafuda|Chou Aniki - Otoko no Tamafuda|Chou Aniki - Otoko no Tamafuda|
Chocobo no Fushigi na Dungeon|Chocobo no Fushigi na Dungeon|Chocobo no Fushigi na Dungeon for WonderSwan|Chocobo no Fushigi na Dungeon for WonderSwan|
Chō Denki Card Game: Youfu Makai - Kikuchi Shuukou|Cho Denki Card Battle Yofu Makai Kikuchi Shugo|Chou Denki Card Game - Youfu Makai - Kikuchi Shuukou|Chou Denki Card Game - Youfu Makai - Kikuchi Shuukou|
Clock Tower|Clock Tower|Clock Tower for WonderSwan|Clock Tower|
Crazy Climber|Crazy Climber|Crazy Climber|Crazy Climber|
Densha de GO! 2|Densha de Go! 2|Densha de Go! 2|Densha de Go! 2|
Densha de GO!|Densha de Go!|Densha de Go!|Densha de Go!|
Dicing Knight.|Dicing Knight|||
Digimon Adventure 02: D1 Tamers|Digimon Adventure 02 - D1 Tamers|||
Digimon Adventure 02: Tag Tamers|Digimon Adventure 02 - Tag Tamers|Digimon Adventure 02 - Tag Tamers|Digimon Adventure 02 - Tag Tamers|
Digimon Adventure: Anode Tamer|Digimon Adventure - Anode Tamer|Digimon Adventure - Anode Tamer|Digimon Adventure - Anode Tamer|
Digimon Adventure: Cathode Tamer|Digimon Adventure - Cathode Tamer|Digimon Adventure - Cathode Tamer|Digimon Adventure - Cathode Tamer|
Digimon Anode & Cathode Tamer|Digimon Digital Monsters - Anode & Cathode Tamer - Veedramon Version|||
Digimon Tamers: Battle Spirit|Digimon Tamers - Battle Spirit|||
Digimon Tamers: Brave Tamer|Digimon Tamers - Brave Tamer|||
Digimon Tamers: Digimon Medley|Digimon Tamers - Digimon Medley|||
Digimon Ver. WonderSwan |Digimon Digital Monsters - Anode & Cathode Tamer - Veedramon Version|Digimon - Ver. WonderSwan|Digimon - Ver. WonderSwan|
Digital Monster: Ver. WonderSwan|Digimon Digital Monsters|Digital Monster - Ver. WonderSwan|Digital Monster - Ver. WonderSwan|
Digital Partner|Digital Partner|Digital Partner|Digital Partner|
Dokodemo Hamster 3: O-Dekake Safuran|Dokodemo Hamster 3 - O Dekake Saffron|||
Dokodemo Hamster|Dokodemo Hamster|Dokodemo Hamster|Dokodemo Hamster|
D's Garage 21 Koubo Game: Tane o Maku Tori|D's Garage 21 Koubo Game - Tane wo Maku Tori|D's Garage 21 Koubo Game - Tane o Maku Tori|D's Garage 21 Koubo Game - Tane wo Maku Tori|
Engacho!|Engacho!|Engacho! for WonderSwan|Engacho!|
Fever: Sankyo Koushiki Pachinko Simulation|Fever Sankyo - Koushiki Pachinko Simulation|Fever - Sankyo Koushiki Pachinko Simulation for WonderSwan|Fever - Sankyo Koushiki Pachinko Simulation|
Final Lap 2000||Final Lap 2000||
Fire Pro Wrestling|Fire Pro Wrestling|Fire Pro Wrestling for WonderSwan|Fire Pro Wrestling|
Fishing Freaks: Bass Rise|Fishing Freaks - Bass Rise|Fishing Freaks - Bass Rise for WonderSwan|Fishing Freaks - Bass Rise|
From TV Animation One Piece: Mezase Kaizoku Ou!|From TV Animation - One Piece - Mezase Kaizoku Ou|From TV Animation One Piece - Mezase Kaizoku Ou!|From TV Animation One Piece - Mezase Kaizoku Ou!|
Front Mission|Front Mission|||
Ganso JaJaMaru-kun|Ganso Jajamaru Kun|Ganso Jajamaru-kun|Ganso Jajamaru-kun|
Glocal Hexcite|Glocal Hexcite|Glocal Hexcite|Glocal Hexcite|
Gomoku Narabe & Reversi Touryuumon|Gomoku Narabe & Reversi Touryuumon|Gomoku Narabe & Reversi - Touryuumon|Gomoku Narabe & Reversi - Touryuumon|
Goraku Ou TANGO!|Gorakuoh TANGO!|Goraku Ou Tango!|Goraku Ou Tango!|
Gunpey EX|GunPey Ex|||
Gunpey|GunPey|GunPey|GunPey|
Hanafuda Shiyouyo|Hanafuda Shiyou Yo|Hanafuda Shiyouyo|Hanafuda Shiyouyo|
Harobots|Harobots|Harobots|Harobots|
Hunter X Hunter:Ishi o Tsugu Mono|Hunter X Hunter - Ichi O Tsugu Mono|Hunter X Hunter - Ishi o Tsugu Mono|Hunter X Hunter - Ishi wo Tsugu Mono|
Judgement Silversword: Rebirth Edition|Judgement Silversword - Rebirth Edition|||
Kakutou Ryouri Densetsu Bistro Recipe: Wonder Battle Hen|Kakuto Ryori Densetsu Bistro Recipe - Wonder Battle Hen|Kakutou Ryouri Densetsu Bistro Recipe - Wonder Battle Hen|Kakutou Ryouri Densetsu Bistro Recipe - Wonder Battle Hen|
Kaze no Klonoa: Moonlight Museum|Kaze no Klonoa - Moonlight Museum|Kaze no Klonoa - Moonlight Museum|Kaze no Klonoa - Moonlight Museum|
Keiba Yosou Shien Shinkaron|Keiba Yosou Shien Shinkaron|Keiba Yosou Shien Soft - Yosou Shinkaron|Keiba Yosou Shien Soft - Yosou Shinkaron|
Kiss Yori... Seaside Serenade|Kiss Yori... - Seaside Serenade|Kiss Yori... - Seaside Serenade|Kiss Yori... - Seaside Serenade|
Kosodate Quiz Dokodemo: My Angel|Kosodate Quiz Doko de mo My Angel|Kosodate Quiz Dokodemo - My Angel|Kosodate Quiz Dokodemo - My Angel|
Kyousouba Ikusei Simulation: KEIBA|Kyoso Uma Ikusei Simulation Keiba|Kyousouba Ikusei Simulation - Keiba|Kyousouba Ikusei Simulation - Keiba|
Langrisser Millennium WS: The Last Century|Langrisser Millenium WS - The Last Century|Langrisser Millennium WS - The Last Century|Langrisser Millennium WS - The Last Century|
Last Stand|LastStand|Last Stand|Last Stand|
Lode Runner|Lode Runner|Lode Runner for WonderSwan|Lode Runner for WonderSwan|
Macross: True Love Song||Macross - True Love Song|Macross - True Love Song|
Magical Drop|Magical Drop|Magical Drop for WonderSwan|Magical Drop for WonderSwan|
Mahjong Touryuumon|Mahjong Touryuumon|Mahjong Touryuumon|Mahjong Touryuumon|
Makaimura|Makaimura|Makaimura for WonderSwan|Makaimura for WonderSwan|
Medarot Perfect Edition: Kabuto Version|Medarot - Perfect Edition Kabuto Version|Medarot Perfect Edition - Kabuto Version|Medarot Perfect Edition - Kabuto Version|
Medarot Perfect Edition: Kuwagata Version|Medarot - Perfect Edition Kuwagata Version|Medarot Perfect Edition - Kuwagata Version|Medarot Perfect Edition - Kuwagata Version|
Meitantei Conan: Majutsushi no Chōsenjō!|Meitantei Conan - Majutsushi no Chousenjou!|Meitantei Conan - Majutsushi no Chousenjou!|Meitantei Conan - Majutsushi no Chousenjou!|
Meitantei Conan: Nishi no Meitantei Saidai no Kiki !?|Meitantei Conan - Nishi no Meitantei Saidai no Kiki!|Meitantei Conan - Nishi no Meitantei Saidai no Kiki!|Meitantei Conan - Nishi no Meitantei Saidai no Kiki!|
Metakomi Theraphy: Nee Kiite!|Meta Communication Therapy nee Kiite!|Metakomi Theraphy - Nee Kiite!|Metakomi Theraphy - Nee Kiite!|
Mingle Magnet|Mingle Magnet|Mingle Magnet|Mingle Magnet|
Mobile Suit Gundam MSVS|Mobile Suit Gundam MSVS|Mobile Suit Gundam MSVS|Mobile Suit Gundam MSVS|
MobileWonderGate|Wondergate|MobileWonderGate||
Moero!! Pro Yakyuu Rookies|Moero !! Pro Yakyu Rookies|Moero!! Pro Yakyuu Rookies|Moero!! Pro Yakyuu Rookies|
Morita Shougi|Morita Shougi|Morita Shougi for WonderSwan||
Mr. Driller|Mr. Driller|||
Name|GoodName|NoIntro|TOSEC|ReDump
Nazo Ou Pocket|Nazo Ou Pocket|Nazo Ou Pocket|Nazo Ou Pocket|
Neon Genesis Evangelion: Shito Ikusei|Neon Genesis Evangelion Shito Ikusei|Neon Genesis Evangelion - Shito Ikusei|Neon Genesis Evangelion - Shito Ikusei|
Nice On|Nice On|Nice On|Nice On|
Nihon Pro Mahjong Renmei Kounin: Tetsuman||Nihon Pro Mahjong Renmei Kounin - Tetsuman|Nippon Pro Mahjong Renmei Kounin Tetsuman|
Nobunaga no Yabou|Nobunaga no Yabo|Nobunaga no Yabou for WonderSwan|Nobunaga no Yabou|
Oh-chan no Oekaki Logic|Ouchan no Oekaki Logic|Ou-chan no Oekaki Logic|Ou-chan no Oekaki Logic|
Pocket Fighter|Pocket Fighter|Pocket Fighter|Pocket Fighter|
Pro Mahjong Kiwame|Pro Mahjong Kiwame|Pro Mahjong Kiwame for WonderSwan|Pro Mahjong Kiwame|
Puyo Puyo 2|Puyo Puyo Tsu|Puyo Puyo Tsuu|Puyo Puyo Tsuu|
Puzzle Bobble|Puzzle Bobble|Puzzle Bobble|Puzzle Bobble|
Rainbow Islands: Putty's Party|Rainbow Islands - Putty's Party|Rainbow Islands - Putty's Party|Rainbow Islands - Putty's Party|
Ring Infinity|Ring Infinity|Ring Infinity|Ring Infinity|
Robot Works|Robot Works|Robot Works|Robot Works|
Rockman & Forte: Mirai kara no Chōsensha|Rockman & Forte - Mirai Kara no Chousen Sha|Rockman & Forte - Mirai Kara no Chousensha|Rockman & Forte - Mirai Kara no Chousensha|
Sangokushi II||San Goku Shi II for WonderSwan|San Goku Shi II for WonderSwan|
Sangokushi|Sangokushi|San Goku Shi for WonderSwan|San Goku Shi for WonderSwan|
SD Gundam: Emotional Jam|SD Gundam - Emotional Jam|SD Gundam - Emotional Jam|SD Gundam - Emotional Jam|
SD Gundam Gashapon Senki: Episode I|SD Gundam Gashapon Senki - Episode 1|SD Gundam Gashapon Senki - Episode 1|SD Gundam Gashapon Senki - Episode 1|
SD Gundam G Generation: Gather Beat|SD Gundam G Generation - Gather Beat|SD Gundam G-Generation - Gather Beat|SD Gundam G-Generation - Gather Beat|
Senkaiden: TV Animation Senkaiden Houshin Engi Yori|Senkaiden - TV Animation Senkaiden Houshin Engi Yori|Senkaiden - TV Animation Senkaiden Houshin Engi Yori|Senkaiden - TV Animation Senkaiden Houshin Engi Yori|
Sennou Millennium|Sennou Millenium|Sennou Millennium|Sennou Millennium|
Shanghai Pocket|Shanghai Pocket|Shanghai Pocket|Shanghai Pocket|
Shin Nihon Pro Wrestling Toukon Retsuden|Shin Nihon Pro Wrestling Toukon Retsuden|Shin Nihon Pro Wrestling - Toukon Retsuden|Shin Nippon Pro Wrestling Toukon Retsuden|
Shougi Touryuumon|Shogi Touryuumon|Shougi Touryuumon|Shougi Touryuumon|
Side Pocket|Side Pocket|Side Pocket for WonderSwan|Side Pocket|
Slither Link|Slither Link|Slither Link|Slither Link|
Soccer Yarou! Challenge The World |Soccer Yarou! - Challenge the World|Soccer Yarou! - Challenge the World|Soccer Yarou! - Challenge the World|
Sotsugyō: Graduation|Sotsugyou|Sotsugyou for WonderSwan|Sotsugyou for WonderSwan|
Space Invaders|Space Invaders|Space Invaders|Space Invaders|
Super Robot Taisen Compact 2: Dai-2-bu: Uchuu Gekishin Hen|Super Robot Taisen Compact 2 - Dai Nibu - Uchuu Gekishin Hen|Super Robot Taisen Compact 2 - Dai-2-bu - Uchuu Gekishin Hen|Super Robot Taisen Compact 2 - Dai-2-Bu - Uchuu Gekishin Hen|
Super Robot Taisen Compact 2: Dai-3-bu: Ginga Kessen Hen|Super Robot Taisen Compact 2 - Dai Sanbu - Ginga Kessen Hen|Super Robot Taisen Compact 2 - Dai-3-bu - Ginga Kessen Hen|Super Robot Taisen Compact 2 - Dai-3-Bu - Ginga Kessen Hen|
Super Robot Taisen Compact 2: Dai Ichibu - Chijou Gekidou Hen|Super Robot Taisen Compact 2 - Dai Ichibu - Chijou Gekidou Hen|Super Robot Taisen Compact 2 - Dai-1-bu - Chijou Gekidou Hen|Super Robot Taisen Compact 2 - Dai-1-Bu - Chijou Gekidou Hen|
Super Robot Taisen: Compact|Super Robot Taisen Compact|Super Robot Taisen Compact|Super Robot Taisen Compact|
Taikyoku Igo: Heisei Kiin|Taikyoku Igo Heisei Kiin|Taikyoku Igo - Heisei Kiin||
Tanjō: Debut|Tanjou - Debut|Tanjou Debut for WonderSwan|Tanjou Debut for WonderSwan|
Tare Panda no Gunpey|Tare Pan no Gunpei|Tare Panda no GunPey|Tare Panda no GunPey|
Tekken Card Challenge|Tekken Card Challenge|Tekken Card Challenge|Tekken Card Challenge|
Terrors|Terrors|Terrors|Terrors|
Tetsujin 28 Gou|Tetsujin 28 Gou|Tetsujin 28 Gou|Tetsujin 28 Gou|
Time Bôkan Series: Bôkan Densetsu - Butamo Odaterya Doronbou|Bokan Densetsu Buta Mo O Daterya Doronbou|Time Bokan Series - Bokan Densetsu - Butamo Odaterya Doronbou|Time Bokan Series - Bokan Densetsu - Butamo Odaterya Doronbou|
Tokyo Majin Gakuen Gehōchō: Keppūroku|Tokyo Majin Gakuen Fuju Fuuroku|Tokyo Majin Gakuen - Fuju Houroku|Tokyo Majin Gakuen - Fuju Houroku|
Trump Collection 2: Bottom-Up Teki Sekaiisshuu no Tabi|Trump Collection 2|Trump Collection 2 - Bottom-Up Teki Sekaiisshuu no Tabi|Trump Collection 2 - Bottom-Up Teki Sekaiisshuu no Tabi|
Trump Collection: Bottom-Up Teki Trump Seikatsu|Trump Collection Bottom Up Teki Trump Seikatsu|Trump Collection - Bottom-Up Teki Trump Seikatsu|Trump Collection - Bottom-Up Teki Trump Seikatsu|
Turntablist: DJ Battle|Turntablist - DJ Battle|Turntablist - DJ Battle|Turntablist - DJ Battle|
Umitsuri ni Ikou!|Umizuri Ni Ikou|Umizuri ni Ikou!|Umizuri ni Ikou!|
Uzumaki: Denshi Kaiki Hen|Uzumaki - Denshi Kaiki Hen|Uzumaki - Denshi Kaiki Hen|Uzumaki - Denshi Kaiki Hen|
Uzumaki: Noroi Simulation|Itou Jun Ni Uzumaki Noroi Simulation|Itou Junji Uzumaki - Noroi Simulation|Itou Junji Uzumaki - Noroi Simulation|
Vaitz Blade|Vaitz Blade|Vaitz Blade|Vaitz Blade|
Wonder Stadium '99|Wonder Stadium '99|Wonder Stadium '99|Wonder Stadium '99|
Wonder Stadium|Wonder Stadium|Wonder Stadium|Wonder Stadium|
WonderSwan Handy Sonar|WonderSwan Handy Sonar|WonderSwan Handy Sonar|WonderSwan Handy Sonar|
Wuz↑b? Produce: Street Dancer|Wasabi Produce - Street Dancer|Wasabi Produce - Street Dancer|Wasabi Produce - Street Dancer|
