5 in 1 Funpak|5 in 1 Funpak|5 in 1 Funpak|5 in 1 Funpak|
Aa Harimanada|Aah! Harimanada|Aa Harimanada|Aa Harimanada|
Aerial Assault|Aerial Assault|Aerial Assault|Aerial Assault|
Alex Kidd in Miracle World|||Alex Kidd in Miracle World|
Alien³|Alien 3|Alien 3|Alien 3|
Alien Syndrome|Alien Syndrome|Alien Syndrome|Alien Syndrome|
Andre Agassi Tennis|Andre Agassi Tennis|Andre Agassi Tennis|Andre Agassi Tennis|
Arcade Classics|Arcade Classics|Arcade Classics|Arcade Classics|
Archer Maclean's Dropzone|Drop Zone|Dropzone|Dropzone|
Arch Rivals|Arch Rivals|Arch Rivals|Arch Rivals|
Arena: Maze of Death|Arena - Maze of Death|Arena|Arena|
Arliel: Crystal Densetsu|Arliel - Crystal Densetsu|Arliel - Crystal Densetsu|Arliel - Crystal Densetsu|
Astérix and the Great Rescue|Asterix and the Great Rescue|Asterix and the Great Rescue|Asterix and the Great Rescue|
Astérix and the Secret Mission||Asterix and the Secret Mission|Asterix and the Secret Mission|
Ax Battler: A Legend of Golden Axe|Ax Battler - A Legend of Golden Axe|Ax Battler - A Legend of Golden Axe|Ax Battler - A Legend of Golden Axe|
Ayrton Senna's Super Monaco GP II|Ayrton Senna's Super Monaco GP II|Ayrton Senna's Super Monaco GP II|Super Monaco GP II|
Baku Baku Animal|Baku Baku Animal|Baku Baku Animal|Baku Baku Animal|
Baku Baku Animal: Sekai Shiiku Gakari Senshuken|Baku Baku Animal - Sekai Shiikugakari Senshu-ken|Baku Baku Animal - Sekai Shiikugakari Senshu-ken|Baku Baku Animal - Sekai Shiikugakari Senshu-ken|
Barbie Super Model||Barbie Super Model|Barbie Super Model|
Batman Forever|Batman Forever|Batman Forever|Batman Forever|
Batman Returns|Batman Returns|Batman Returns|Batman Returns|
Batter Up|Batter Up|Batter Up|Batter Up|
Battleship|Battleship|Battleship|Battleship|
Battletoads|Battletoads|Battletoads|Battletoads|
Beavis and Butt-head|Beavis and Butt-head|Beavis and Butt-head|Beavis and Butt-head|
Berlin no Kabe|Berlin no Kabe|Berlin no Kabe|Berlin no Kabe|
Bishōjo Senshi Sailor Moon S|Bishoujo Senshi Sailor Moon S|Bishoujo Senshi Sailor Moon S|Bishoujo Senshi Sailor Moon S|
Bonkers: Wax Up!|Bonkers Wax Up!|Bonkers Wax Up!|Bonkers - Wax Up!|
Bram Stoker's Dracula|Bram Stoker's Dracula|Bram Stoker's Dracula|Dracula|
Bubble Bobble|Bubble Bobble|Bubble Bobble|Bubble Bobble|
Bugs Bunny in Double Trouble|Bugs Bunny in Double Trouble|Bugs Bunny in Double Trouble|Bugs Bunny in Double Trouble|
Bust-A-Move|Bust-A-Move|Bust-A-Move|Bust-A-Move|
Buster Ball|Buster Ball|Buster Ball|Buster Ball|
Buster Fight|Buster Fight|Buster Fight|Buster Fight|
Caesar's Palace|Caesar's Palace|Caesars Palace|Caesars Palace|
Captain America and The Avengers|Captain America and the Avengers|Captain America and the Avengers|Captain America and The Avengers|
Car Licence|Car Licence|Car Licence||
Casino FunPak|Casino Funpak|Casino Funpak|Casino Funpak|
Castle of Illusion starring Mickey Mouse|Castle of Illusion Starring Mickey Mouse|Castle of Illusion Starring Mickey Mouse|Castle of Illusion Starring Mickey Mouse|
Chakan|Chakan|Chakan|Chakan|
Championship Hockey||Championship Hockey|Championship Hockey|
Chaos 89|Chaos 89|||
Chase H.Q.|Chase H.Q.|Taito Chase H.Q.|Chase H.Q.|
Cheese Cat-Astrophe Starring Speedy Gonzales||Cheese Cat-Astrophe - Starring Speedy Gonzales|Cheese Cat-astrophe Starring Speedy Gonzales|
Chicago Syndicate|Chicago Syndicate|Chicago Syndicate|Chicago Syndicate|
Choplifter III|Choplifter III|Choplifter III|Choplifter III|
Chuck Rock|Chuck Rock|Chuck Rock|Chuck Rock|
Chuck Rock II: Son of Chuck|Chuck Rock II - Son of Chuck|Chuck Rock II - Son of Chuck|Chuck Rock II - Son of Chuck|
CJ: Elephant Fugitive||CJ Elephant Fugitive||
Cliffhanger|Cliffhanger|Cliffhanger|Cliffhanger|
Clutch Hitter|Clutch Hitter|Clutch Hitter|Clutch Hitter|
Coca Cola Kid|Coca Cola Kid|Coca Cola Kid|Coca-Cola Kid|
Columns|Columns|Columns|Columns|
Cool Spot|Cool Spot|Cool Spot||
Cool Spot (Revision 1)|||Cool Spot Rev 1|
Cosmic Spacehead|Cosmic Spacehead|Cosmic Spacehead|Cosmic Spacehead|
Crayon Shin-chan: Taiketsu! Tankam Panic!|Crayon Shin-Chan - Taiketsu! Tankam Panic!!|Crayon Shin-chan - Taiketsu! Kantam Panic|Crayon Shin Chan - Taiketsu! Tankam Panic!!|
Crystal Warriors|Crystal Warriors|Crystal Warriors|Crystal Warriors|
Cutthroat Island|Cutthroat Island|Cutthroat Island|Cutthroat Island|
Daffy Duck in Hollywood|Daffy Duck in Hollywood|Daffy Duck in Hollywood|Daffy Duck in Hollywood|
Deep Duck Trouble starring Donald Duck|Deep Duck Trouble Starring Donald Duck|Deep Duck Trouble Starring Donald Duck|Deep Duck Trouble Starring Donald Duck|
Defenders of Oasis|Defenders of Oasis|Defenders of Oasis|Defenders of Oasis|
Desert Speedtrap Starring Road Runner and Wile E. Coyote|Desert Speedtrap - Starring Road Runner and Wile E. Coyote|Desert Speedtrap|Desert Speedtrap Starring Road Runner and Wile E. Coyote|
Desert Strike: Return to the Gulf|Desert Strike - Return to the Gulf|Desert Strike - Return to the Gulf|Desert Strike - Return to the Gulf|
Devilish|Devilish|Devilish|Devilish|
Devilish (Revision 1)|||Devilish Rev 1|
Disney's Aladdin|Aladdin|Aladdin|Aladdin|
Disney's Aladdin|Aladdin Rev 19940113|Aladdin Rev 19940111|Aladdin Rev 19931229|
Disney's Ariel the Little Mermaid|Ariel - The Little Mermaid|Ariel the Little Mermaid|Ariel - The Little Mermaid|
Disney's The Jungle Book|Jungle Book, The|Jungle Book, The|Jungle Book, The|
Disney's the Lion King|Lion King, The|Lion King, The|Lion King, The|
Donald Duck no Lucky Dime||Donald Duck no Lucky Dime|Donald Duck no Lucky Dime|
Donald no Magical World||Donald no Magical World||
Doraemon: Waku Waku Pocket Paradise|Doraemon - Waku Waku Pocket Paradise|Doraemon - Waku Waku Pocket Paradise|Doraemon - Waku Waku Pocket Paradise|
Double Dragon|Double Dragon|Double Dragon|Double Dragon|
Dragon Crystal|Dragon Crystal|Dragon Crystal|Dragon Crystal|
Dragon: The Bruce Lee Story|Dragon - The Bruce Lee Story|Dragon - The Bruce Lee Story|Dragon|
Dr. Robotnik's Mean Bean Machine|Dr. Robotnik's Mean Bean Machine|Dr. Robotnik's Mean Bean Machine|Dr. Robotnik's Mean Bean Machine|
Dunk Kid's|Dunk Kid's|Dunk Kids|Dunk Kids|
Dynamite Headdy|Dynamite Headdy|Dynamite Headdy|Dynamite Headdy|
Earthworm Jim|Earthworm Jim|Earthworm Jim|Earthworm Jim|
Ecco the Dolphin|Ecco the Dolphin|Ecco the Dolphin|Ecco|
Ecco: The Tides of Time|Ecco II - The Tides of Time|||
Ecco: The Tides of Time|Ecco - The Tides of Time|Ecco II - The Tides of Time|Ecco II - The Tides of Time|
Ernie Els Golf|Ernie Els Golf|Ernie Els Golf|Ernie Els Golf|
Eternal Legend|Eternal Legend|Eternal Legend|Eternal Legend|
Evander Holyfield's "Real Deal" Boxing|Evander Holyfield's 'Real Deal' Boxing|Evander Holyfield Boxing|Evander Holyfield Boxing|
F-15 Strike Eagle|F-15 Strike Eagle|F-15 Strike Eagle|F-15 Strike Eagle|
F1|F-1|F1|F1|
F1: World Championship Edition||F1 - World Championship Edition||
Faceball 2000|Faceball 2000|Faceball 2000|Faceball 2000|
Factory Panic|Factory Panic|Factory Panic|Factory Panic|
Fantastic Dizzy|Fantastic Dizzy|Fantastic Dizzy|Fantastic Dizzy|
Fantasy Zone Gear|Fantasy Zone Gear|Fantasy Zone Gear|Fantasy Zone Gear|
Fatal Fury Special|Fatal Fury Special|Fatal Fury Special|Fatal Fury Special|
FIFA International Soccer|FIFA International Soccer|FIFA International Soccer|FIFA International Soccer|
FIFA Soccer '96|FIFA Soccer 96|FIFA Soccer 96|FIFA Soccer 96|
Fire Track|Fire Track by Ben Ryves|||
Foreman for Real|Foreman for Real|Foreman for Real|Foreman for Real|
Frank Thomas Big Hurt Baseball|Frank Thomas Big Hurt Baseball|Frank Thomas Big Hurt Baseball|Frank Thomas Big Hurt Baseball|
Fray: Shugyou Hen||Fray - Shugyou Hen|Fray - Shugyou hen|
Fred Couples' Golf|Fred Couples Golf|Fred Couples' Golf|Fred Couples Golf|
Frogger|Frogger|Frogger|Frogger|
Frogs|Frogs by Charles Doty|||
From TV Animation: Slam Dunk: Shouri heno Starting 5|From TV Animation - Slam Dunk - Shouri heno Starting 5|From TV Animation - Slam Dunk - Shouri heno Starting 5|From TV Animation - Slam Dunk - Shouri he no Starting 5|
Galaga 2||Galaga 2|Galaga 2|
Galaga '91|Galaga '91|Galaga '91|Galaga '91|
Gamble Panic|Gamble Panic|Gamble Panic|Gamble Panic|
Gambler Jiko Chūshinha|Gambler Jikochuushin Ha|Gambler Jikochuushinha|Gambler Jiko Chuushin Ha|
Ganbare Gorby!|Ganbare Gorby!|Ganbare Golby!|Ganbare Gorby!|
Garfield: Caught in the Act|Garfield - Caught in the Act|Garfield - Caught in the Act|Garfield - Caught in the Act|
Garou Densetsu Special||Garou Densetsu Special|Garou Densetsu Special|
Gear Stadium|Gear Stadium|Gear Stadium|Gear Stadium|
Gear Stadium Heiseiban|Gear Stadium Heiseiban|Gear Stadium Heiseiban|Gear Stadium Heiseiban|
Gear Works|Gear Works|Gear Works|Gear Works|
George Foreman's KO Boxing|George Foreman's KO Boxing|George Foreman's KO Boxing|George Foreman's KO Boxing|
GG Aleste|GG Aleste|GG Aleste|GG Aleste|
GG Demo|GG Demo by Charles MacDonald|||
GG Doraemon: Nora no Suke no Yabou|GG Doraemon - Nora no Suke no Yabou|GG Doraemon - Noranosuke no Yabou|GG Doraemon - Nora no Suke no Yabou|
GG Hicolor Demo|GG Hicolor Demo by Chris Covell|||
GG Hi-Res Graphics Demo|GG Hi-Res Graphics Demo by Charles McDonald|||
GG Nibbles|GG Nibbles by Martin Konrad V1||GG Nibbles|
GG Nibbles (Version 2)|GG Nibbles by Martin Konrad V2|||
GG Nibbles (Version 3)|GG Nibbles by Martin Konrad V3|||
GG Nibbles (Version 4)|GG Nibbles by Martin Konrad V4|||
GG Portrait: Pai Chan|GG Portrait - Pai Chan|GG Portrait - Pai Chen||
GG Portrait: Yuuki Akira|GG Portrait - Yuuki Akira|GG Portrait - Yuuki Akira||
GG Turrican Demo|GG Turrican Demo V1.0 by Martin Konrad||GG Turrican|
GG Turrican Demo (Version 0.9)|GG Turrican Demo V0.9 by Martin Konrad|||
G-LOC Air Battle|G-LOC Air Battle|G-Loc Air Battle|G-Loc Air Battle|
Godzilla: Kaiju Dai Shingeki|Godzilla - Kaiju Dai Shingeki|Godzilla - Kaijuu Daishingeki|Godzilla - Kaiju Dai Shingeki|
GP Rider|GP Rider|GP Rider|GP Rider|
GP Rider|GP Rider||GP Rider Rev 19940104|
Greendog: The Beached Surfer Dude!|Greendog|Greendog|Greendog|
Griffin|Griffin|Griffin|Griffin|
Gunstar Heroes|Gunstar Heroes|Gunstar Heroes|Gunstar Heroes|
Halley Wars|Halley Wars|Halley Wars|Halley Wars|
Head Buster|Head Buster|Head Buster|Head Buster|
Heavyweight Champ||Heavy Weight Champ|Heavyweight Champ|
Home Alone|Home Alone|Home Alone|Home Alone|
Honō no Tōkyūji: Dodge Danpei|Honoo no Doukyuuji - Dodge Danpei|Honoo no Toukyuuji - Dodge Danpei|Honoo no Doukyuuji - Dodge Danpei|
Hook|Hook|Hook|Hook|
House of Tarot|House of Tarot|House of Tarot|House of Tarot|
Hurricanes|Hurricanes|Hurricanes|Hurricanes|
Hyokkori Hyoutan Jima: Hyoutan Jima no Daikoukai|Hyokkori Hyoutan Jima|Hyokkori Hyoutan Jima - Hyoutan Jima no Daikoukai|Hyokkori Hyoutan Jima - Hyoutan Jima no Daikoukai|
Hyper Chou Pro Yakyuu '92|Hyper Chou Pro Yakyuu '92|Hyper Chou Pro Yakyuu '92|Hyper Chou Pro Yakyuu '92|
Indiana Jones and the Last Crusade|Indiana Jones and the Last Crusade|Indiana Jones and the Last Crusade|Indiana Jones and the Last Crusade|
In the Wake of Vampire|In the Wake of Vampire|In the Wake of Vampire|In the Wake of Vampire|
Iron Man: X-O Manowar in Heavy Metal|Iron Man X-O Manowar in Heavy Metal|Iron Man X-O Manowar in Heavy Metal|Iron Man X-O Manowar in Heavy Metal|
James Bond 007: The Duel|James Bond 007 - The Duel|James Bond 007 - The Duel|James Bond 007 - The Duel|
James Pond 3: Operation Starfi5h|James Pond 3 - Operation Starfish|James Pond 3 - Operation Starfi5h|James Pond 3 - Operation Starfish|
James Pond II: Codename: RoboCod|James Pond II - Codename RoboCod|James Pond II - CodeRoboCod|James Pond II - CodeRoboCod|
Jang Pung II|Jang Pung II|Jang Pung II|Jang Pung II|
Jeopardy!|Jeopardy!|Jeopardy!|Jeopardy!|
Jeopardy! Sports Edition|Jeopardy! - Sports Edition|Jeopardy! - Sports Edition|Jeopardy! - Sports Edition|
J-League GG Pro Striker '94||J.League GG Pro Striker '94||
J.League GG Pro-Striker '94||J.League GG Pro Striker '94|J.League GG Pro-Striker '94|
J-League Soccer: Dream Eleven|J.League Soccer - Dream Eleven|J.League Soccer - Dream Eleven||
J-League Soccer: Dream Eleven|J.League Soccer - Dream Eleven|J.League Soccer - Dream Eleven|J.League Soccer - Dream Eleven|
Joe Montana's Football|Joe Montana's Football|Joe Montana's Football|Joe Montana Football|
Journey from Darkness: Strider Returns|Strider Returns|Journey from Darkness - Strider Returns|Strider Returns - Journey from Darkness|
Judge Dredd|Judge Dredd|Judge Dredd|Judge Dredd|
Junction|Junction|Junction|Junction|
Jungle Strike||Jungle Strike|Jungle Strike|
Jurassic Park|Jurassic Park|Jurassic Park|Jurassic Park|
Kaitou Saint Tail|Kaitou Saint Tail|Kaitou Saint Tale|Kaitou Saint Tail|
Kawasaki Superbike Challenge|Kawasaki Superbike Challenge|Kawasaki Superbike Challenge|Kawasaki Superbike Challenge|
Kenyū Densetsu Yaiba|Kenyuu Densetsu Yaiba|Kenyuu Densetsu Yaiba|Kenyuu Densetsu Yaiba|
Kick & Rush|Kick & Rush|Kick & Rush|Kick & Rush|
Kinetic Connection|Kinetic Connection|Kinetic Connection|Kinetic Connection|
Kishin Dōji ZENKI|Kishin Douji Zenki|Kishin Douji Zenki|Kishin Douji Zenki|
Klax|Klax|Klax|Klax|
Krusty's Fun House|Simpsons, The - Krusty's Fun House|Krusty's Fun House|Krusty's Fun House|
Kuni-chan no Game Tengoku|Kuni-chan no Game Tengoku|Kuni-chan no Game Tengoku|Kuni-chan no Game Tengoku|
Kuni-chan no Game Tengoku Part 2|Kuni-chan no Game Tengoku Part 2|Kuni-chan no Game Tengoku Part 2|Kuni-chan no Game Tengoku Part 2|
Land of Illusion Starring Mickey Mouse|Land of Illusion Starring Mickey Mouse|Land of Illusion Starring Mickey Mouse|Land of Illusion Starring Mickey Mouse|
Last Action Hero|Last Action Hero|Last Action Hero|Last Action Hero|
Legend of Illusion Starring Mickey Mouse|Legend of Illusion Starring Mickey Mouse|Legend of Illusion Starring Mickey Mouse|Legend of Illusion Starring Mickey Mouse|
Lemmings|Lemmings|Lemmings|Lemmings|
Les Schtroumpfs 2|||Schtroumpfs 2, Les|
Les Schtroumpfs|||Schtroumpfs, Les|
Lunar: Sanpo-suru Gakuen|Lunar - Sanposuru Gakuen|Lunar - Sanposuru Gakuen|Lunar - Sanposuru Gakuen|
Madden NFL '95|Madden NFL '95|Madden NFL '95|Madden NFL '95|
Madden NFL '96|Madden NFL '96|Madden NFL '96|Madden 96|
Madō Monogatari A: DokiDoki Vacation|Madou Monogatari A - Doki Doki - Bake Shon|Madou Monogatari A - Dokidoki Vacation|Madou Monogatari A - Doki Doki - Bake Shon|
Madō Monogatari I: 3tsu no Madoukyuu|Madou Monogatari I|Madou Monogatari I - Mitsu no Madoukyuu|Madou Monogatari I - 3tsu no Madoukyuu|
Madō Monogatari II: Arle 16-sai|Madou Monogatari II - Aruru 16-sai|Madou Monogatari II - Aruru 16sai|Madou Monogatari II - Aruru 16-sai|
Madō Monogatari III: Kyūkyoku Joō-sama|Madou Monogatari III - Kyukyoku Joo-sama|Madou Monogatari III - Kyuukyoku Joou-sama|Madou Monogatari III - Kyuukyoku Joo-sama|
Magical Puzzle Popils|Magical Puzzle Popils|Magical Puzzle Popils|Magical Puzzle Popils|
Magical Tarurūto-kun|Magical Taruruuto-kun|Magical Taruruuto-kun|Magical Taruruuto-kun|
Magic Knight Rayearth 2: Making of Magic Knight|Magic Knight Rayearth 2 - Making of Magic Knight|Magic Knight Rayearth 2 - Making of Magic Knight|Mahou Kishi Rayearth 2 - Making of Magic Knight|
Magic Knight Rayearth|Magic Knight Rayearth|Magic Knight Rayearth|Mahou Kishi Rayearth|
Majesco Game Gear BIOS|Majesco Game Gear BIOS|Sega Game Gear||
Mappy|Mappy|Mappy|Mappy|
Marble Madness|Marble Madness|Marble Madness|Marble Madness|
Marko's Magic Football|Marko's Magic Football|Marko's Magic Football|Marko's Magic Football|
Master of Darkness||Master of Darkness|Master of Darkness|
Mega Man|Megaman|Mega Man|Mega Man|
Megami Tensei Gaiden: Last Bible|Megami Tensei Gaiden - Last Bible|Megami Tensei Gaiden - Last Bible|Megami Tensei Gaiden - Last Bible|
Megami Tensei Gaiden: Last Bible Special|Megami Tensei Gaiden - Last Bible Special|Megami Tensei Gaiden - Last Bible S|Megami Tensei Gaiden - Last Bible Special|
Mickey Mouse Densetsu no Oukoku: Legend of Illusion||Mickey Mouse Densetsu no Oukoku - Legend of Illusion||
Mickey's Ultimate Challenge|Mickey's Ultimate Challenge|Mickey's Ultimate Challenge|Mickey's Ultimate Challenge|
Mick & Mack as the Global Gladiators|Mick & Mack as the Global Gladiators|Mick & Mack as the Global Gladiators|Mick & Mack as The Global Gladiators|
Micro Machines 2: Turbo Tournament|Micro Machines 2 - Turbo Tournament|Micro Machines 2 - Turbo Tournament|Micro Machines 2 - Turbo Tournament|
Micro Machines|Micro Machines|Micro Machines|Micro Machines|
Mighty Morphin Power Rangers|Mighty Morphin Power Rangers|Mighty Morphin Power Rangers|Mighty Morphin Power Rangers|
Mighty Morphin' Power Rangers: The Movie|Mighty Morphin Power Rangers - The Movie|Mighty Morphin Power Rangers - The Movie|Mighty Morphin Power Rangers - The Movie|
MLBPA Baseball|MLBPA Baseball|MLBPA Baseball|MLBPA Baseball|
Moldorian: Hikari to Yami no Sister|Moldorian|Moldorian - Hikari to Yami no Sister|Moldorian|
Monster Truck Wars|Monster Truck Wars|Monster Truck Wars|U.S.H.R.A. Monster Truck Wars|
Monster World II: Dragon no Wana|Monster World II - Dragon no Wana|Monster World II - Dragon no Wana|Monster World II - Dragon no Wana|
Mortal Kombat 3|Mortal Kombat 3|Mortal Kombat 3|Mortal Kombat 3|
Mortal Kombat II|Mortal Kombat II|Mortal Kombat II|Mortal Kombat II|
Mortal Kombat|Mortal Kombat|Mortal Kombat|Mortal Kombat|
Ms. Pac-Man|Ms. Pac-Man|Ms. Pac-Man|Ms. Pac-Man|
Name|GoodName|NoIntro|TOSEC|ReDump
Nazo Puyo 2|Nazo Puyo 2|Nazo Puyo 2|Nazo Puyo 2|
Nazo Puyo: Arle no Roux|Nazo Puyo Aruru no Ru|Nazo Puyo Aruru no Ru|Nazo Puyo - Aruru no Ru|
Nazo Puyo|Nazo Puyo|Nazo Puyo|Nazo Puyo Rev 0|
Nazo Puyo (Revision 1)|||Nazo Puyo Rev 1|
NBA Action Starring David Robinson|NBA Action|NBA Action|NBA Action Starring David Robinson|
NBA Jam|NBA Jam|NBA Jam|NBA Jam|
NBA Jam TE|NBA Jam Tournament Edition|NBA Jam Tournament Edition|NBA Jam - Tournament Edition|
Neko Daisuki!|Neko Daisuki!|Neko Daisuki!|Neko Daisuki!|
NFL '95|NFL '95|NFL '95|NFL '95|
NFL Quarterback Club '95|NFL Quarterback Club|NFL Quarterback Club|NFL Quarterback Club|
NFL Quarterback Club '96|NFL Quarterback Club '96|NFL Quarterback Club '96|NFL Quarterback Club 96|
NHL All-Star Hockey|NHL All-Star Hockey|NHL All-Star Hockey|NHL All-Star Hockey|
NHL Hockey|NHL Hockey|NHL Hockey|NHL Hockey|
Ninja Gaiden|Ninja Gaiden|Ninja Gaiden|Ninja Gaiden|
Ninku 2: Tenkuryu-e no Michi|Ninku 2 - Tenkuryu-e no Michi|Ninku 2 - Tenkuryu-e no Michi|Ninku 2 - Tenkuryu-e no Michi|
Ninku Gaiden: Hiroyuki Daikatsugeki|Ninku Gaiden - Hiroyuki Daikatsugeki|Ninku Gaiden - Hiroyuki Daikatsugeki|Ninku Gaiden - Hiroyuki Daikatsugek|
Ninku|Ninku|Ninku|Ninku|
Nomo's World Series Baseball|Nomo's World Series Baseball|Nomo's World Series Baseball|Nomo's World Series Baseball|
Olympic Gold: Barcelona '92|Olympic Gold - Barcelona '92|Olympic Gold|Olympic Gold|
Out Run Europa|OutRun Europa|Out Run Europa|Out Run Europa|
Out Run|OutRun|Out Run|Out Run|
Pac-Attack|Pac-Attack|Pac-Attack|Pac-Attack|
Pac-in-Time|Pac-In-Time|Pac-In-Time|Pac-In-Time|
Pac-Man|Pac-Man|Pac-Man|Pac-Man|
Panzer Dragoon Mini|Panzer Dragoon Mini|Panzer Dragoon Mini|Panzer Dragoon Mini|
Paperboy 2|Paperboy 2|Paperboy II|Paperboy II|
Paperboy|Paperboy|Paperboy|Paperboy|
Pengo|Pengo|Pengo|Pengo|
Pet Club Inu Daisuki!|Pet Club Inu Daisuki!|Pet Club Inu Daisuki!|Pet Club Inu Daisuki!|
Pete Sampras Tennis|Pete Sampras Tennis|Pete Sampras Tennis|Pete Sampras Tennis|
PGA Tour '96|PGA Tour 96|PGA Tour 96|PGA Tour 96|
PGA Tour Golf II|PGA Tour Golf II|PGA Tour Golf II|PGA Tour Golf II|
PGA Tour Golf|PGA Tour Golf|PGA Tour Golf|PGA Tour Golf|
Phantasy Star Adventure|Phantasy Star Adventure|Phantasy Star Adventure|Phantasy Star Adventure|
Phantasy Star Gaiden|Phantasy Star Gaiden|Phantasy Star Gaiden|Phantasy Star Gaiden|
Phantom 2040|Phantom 2040|Phantom 2040|Phantom 2040|
Pinball Dreams|Pinball Dreams|Pinball Dreams|Pinball Dreams|
Pocket Jansou|Pocket Jansou|Pocket Jansou|Pocket Jansou|
Pokémon Legends|Pokemon Legends|||
Poker Face Paul's Blackjack|Poker Faced Paul's Blackjack|Poker Faced Paul's Blackjack|Poker Faced Paul's Blackjack|
Poker Face Paul's Gin|Poker Faced Paul's Gin|Poker Faced Paul's Gin|Poker Faced Paul's Gin|
Poker Face Paul's Poker|Poker Faced Paul's Poker|Poker Faced Paul's Poker|Poker Faced Paul's Poker|
Poker Face Paul's Solitaire|Poker Faced Paul's Solitaire|Poker Faced Paul's Solitaire|Poker Faced Paul's Solitaire|
Pop Breaker|Pop Breaker|Pop Breaker|Pop Breaker|
Popeye: Beach Volleyball|Popeye's Beach Volleyball|Popeye Beach Volleyball|Popeye Beach Volley Ball|
Power Drive||Power Drive|Powerdrive|
Power Strike II|Power Strike II|Power Strike II|Power Strike II|
Predator 2|Predator 2|Predator 2|Predator 2|
Primal Rage|Primal Rage|Primal Rage|Primal Rage|
Prince of Persia|Prince of Persia|Prince of Persia|Prince of Persia|
Pro Yakyuu GG League '94|Pro Yakyuu GG League '94|Pro Yakyuu GG League '94|Pro Yakyuu GG League '94|
Pro Yakyuu GG League|||Pro Yakyuu GG League|
Psychic World|Psychic World|Psychic World|Psychic World|
Putt & Putter|Putt & Putter|Putt & Putter|Putt & Putter|
Puyo Puyo 2|Puyo Puyo 2|Puyo Puyo 2|Puyo Puyo 2|
Puyo Puyo||Puyo Puyo||
Puzlow Kids|Puzlow Kids||Puzlow Kids|
Puzzle & Action: Ichidant-R|Ichidant~R GG - Puzzle & Action|Ichidant~R GG|Puzzle & Action - Ichidanto A-Ru GG|
Puzzle & Action: Tanto-R|Tanto-R|Puzzle and Action Tanto-R|Puzzle & Action - Tanto-R|
Puzzle & Action: Tant-R|Ichidant~R GG - Puzzle & Action|Ichidant~R GG||
Puzzle Bobble|Puzzle Bobble|Puzzle Bobble|Puzzle Bobble|
Rastan Saga|Rastan Saga|Rastan Saga|Rastan Saga|
RBI Baseball '94|R.B.I. Baseball '94|R.B.I. Baseball '94|R.B.I. Baseball '94|
R.C. Grand Prix|R.C. Grand Prix|R.C. Grand Prix|R.C. Grand Prix|
Revenge of Drancon|Revenge of Drancon|Revenge of Drancon|Revenge of Drancon|
Riddick Bowe Boxing|Riddick Bowe Boxing|Riddick Bowe Boxing|Riddick Bowe Boxing|
Rise of the Robots|Rise of the Robots|Rise of the Robots|Rise of the Robots|
Ristar: The Shooting Star|Ristar the Shooting Star|Ristar - The Shooting Star|Ristar|
Road Rash|Road Rash|Road Rash|Road Rash|
Robocop 3|Robocop 3|RoboCop 3|RoboCop 3|
Robocop Versus The Terminator|Robocop versus The Terminator|RoboCop versus The Terminator|RoboCop Versus The Terminator|
Ronald in the Magical World|Ronald in the Magical World|Donald no Magical World|Ronald in The Magical World|
Royal Stone: Hikarishi Toki no Tobira|Royal Stone|Royal Stone - Hikarishi Toki no Tobira|Royal Stone|
Ryu Kyu|Ryu Kyu|Ryuu Kyuu|Ryu Kyu|
Saban's VR Troopers|VR Troopers|VR Troopers|VR Troopers|
Samurai Shodown|Samurai Shodown|Samurai Shodown|Samurai Shodown|
Samurai Spirits|Samurai Spirits|Samurai Spirits|Samurai Spirits|
Scratch Golf|Scratch Golf|Scratch Golf|Scratch Golf|
SD Gundam: Winner's History|SD Gundam - Winner's History|SD Gundam - Winner's History|SD Gundam - Winner's History|
Secret of Monkey Island Demo (V1.0)|MOD2PSG V1.0 - Secret of Monkey Island|||
Secret of Monkey Island Demo (V1.1)|MOD2PSG V1.1 - Secret of Monkey Island|||
Secret of Monkey Island Demo (V1.2)|MOD2PSG V1.2 - Secret of Monkey Island|||
Secret of Monkey Island Demo (V1.3)|MOD2PSG V1.3 - Secret of Monkey Island|||
Secret of Monkey Island Demo (V1.5)|MOD2PSG V1.5 - Secret of Monkey Island|||
Secret of Monkey Island Demo (V1.6)|MOD2PSG V1.6 - Secret of Monkey Island|||
Secret of Monkey Island Demo (V1.7)|MOD2PSG V1.7 - Secret of Monkey Island|||
Secret of Monkey Island Demo (V1.8)|MOD2PSG V1.8 - Secret of Monkey Island|||
Sega Game Pack 4 in 1|Sega Game Pack 4 in 1|Sega Game Pack 4 in 1|Sega Game Pack - 4 in 1|
Sega Tween|Sega Tween by Ben Ryves|||
Sensible Soccer: European Champions: 92/93 Edition|Sensible Soccer|Sensible Soccer|Sensible Soccer|
Shadam Crusader|Shadam Crusader|Shadam Crusader - Harukanaru Oukoku|Shadam Crusader|
Shadow of the Beast Demo (V1.3)|MOD2PSG V1.3 - Shadow of the Beast|||
Shadow of the Beast Demo (V1.5)|MOD2PSG V1.5 - Shadow of the Beast|||
Shadow of the Beast Demo (V1.6)|MOD2PSG V1.6 - Shadow of the Beast|||
Shadow of the Beast Demo (V1.7)|MOD2PSG V1.7 - Shadow of the Beast|||
Shadow of the Beast Demo (V1.8)|MOD2PSG V1.8 - Shadow of the Beast|||
Shanghai II|Shanghai II|Shanghai II|Shanghai II|
Shaq Fu|Shaq Fu|Shaq Fu|Shaq Fu|
Shi-Kin-Joh|Shikinjou|Shikinjou|Sikin Jyo|
Shining Force Gaiden: Final Conflict|Shining Force Gaiden - Final Conflict|Shining Force Gaiden - Final Conflict|Shining Force Gaiden - Final Conflict|
Shining Force Gaiden II: Jashin no Kakusei|Shining Force Gaiden II|Shining Force Gaiden II - Jashin no Kakusei|Shining Force Gaiden II|
Shining Force Gaiden|Shining Force Gaiden|Shining Force Gaiden|Shining Force Gaiden|
Shining Force II: The Sword of Hajya|Shining Force II - The Sword of Hajya|Shining Force II - The Sword of Hajya|Shining Force II - The Sword of Hajya|
Shinobi|GG Shinobi|Shinobi|GG Shinobi, The|
Shinobi II: The Silent Fury|Shinobi II - The Silent Fury|GG Shinobi II, The - The Silent Fury|GG Shinobi Part II, The - The Silent Fury|
Side Pocket|Side Pocket|Side Pocket|Side Pocket|
Simple Text Demo|Simple Text Demo by Charles Doty|||
Skweek|Skweek|Skweek|Skweek|
Slider|Slider|Slider|Slider|
Solitaire FunPak|Solitaire Funpak|Solitaire Funpak|Solitaire Funpak|
Solitaire Poker|Solitaire Poker|Solitaire Poker|Solitaire Poker|
Sonic Blast|Sonic Blast|Sonic Blast|Sonic Blast|
Sonic Drift 2|Sonic Drift 2|Sonic Drift 2|Sonic Drift 2|
Sonic Drift|Sonic Drift|Sonic Drift|Sonic Drift|
Sonic Labyrinth|Sonic Labyrinth|Sonic Labyrinth|Sonic Labyrinth|
Sonic Spinball|Sonic Spinball|Sonic Spinball|Sonic Spinball|
Sonic & Tails 2|Sonic & Tails 2|Sonic & Tails 2|Sonic & Tails 2|
Sonic & Tails|Sonic & Tails|Sonic & Tails|Sonic & Tails|
Sonic The Hedgehog 2|Sonic The Hedgehog 2|Sonic the Hedgehog 2|Sonic the Hedgehog 2|
Sonic The Hedgehog Chaos|Sonic Chaos|Sonic Chaos|Sonic Chaos|
Sonic The Hedgehog|Sonic The Hedgehog|Sonic The Hedgehog|Sonic the Hedgehog|
Sonic The Hedgehog: Triple Trouble|Sonic The Hedgehog - Triple Trouble|Sonic the Hedgehog - Triple Trouble|Sonic the Hedgehog - Triple Trouble|
Soukoban|Soukoban|Soukoban|Soukoban|
Space Harrier|Space Harrier|Space Harrier|Space Harrier|
Spider-Man and the X-Men|Spider-Man and the X-Men in Arcade's Revenge|Spider-Man and the X-Men in Arcade's Revenge|Spider-Man X-Men - Arcade's Revenge|
Spider-Man: Return of the Sinister Six|Spider-Man - Return of the Sinister Six|Spider-Man - Return of the Sinister Six|Spider-Man - Return of the Sinister Six|
Spider-Man vs The Kingpin|Spider-Man vs. The Kingpin|Spider-Man vs. The Kingpin|Spider-Man vs. The Kingpin|
Spirou||Spirou|Spirou|
Sports Illustrated Championship Football & Baseball|Sports Illustrated Championship Football & Baseball|Sports Illustrated Championship Football & Baseball|Sports Illustrated - Championship Football & Baseball|
Sports Trivia: Championship Edition|Sports Trivia - Championship Edition|Sports Trivia - Championship Edition|Sports Trivia - Championship Edition|
Sports Trivia|Sports Trivia|Sports Trivia|Sports Trivia|
S.S. Lucifer - Man Overboard!|S.S. Lucifer - Man Overboard!|S.S. Lucifer - Man Overboard!|S.S. Lucifer - Man Overboard!|
Stargate|Stargate|Stargate|Stargate|
Star Trek Generations - Beyond the Nexus|Star Trek Generations - Beyond the Nexus|Star Trek Generations - Beyond the Nexus|Star Trek - Generations - Beyond the Nexus|
Star Trek The Next Generation: The Advanced Holodeck Tutorial|Star Trek TNG - Advanced Holodeck Tutorial|Star Trek - The Next Generation - The Advanced Holodeck Tutorial|Star Trek - The Next Generation|
Star Wars|Star Wars|Star Wars|Star Wars|
Street Hero||Street Hero|Street Hero|
Streets of Rage II|Streets of Rage II|Streets of Rage II|Streets of Rage II|
Streets of Rage|Streets of Rage|Streets of Rage|Streets of Rage|
Striker||Striker|Striker|
Super Battletank|Super Battletank|Super Battletank|Super Battletank|
Super Columns|||Super Columns Rev 19941111|
Super Columns|Super Columns|Super Columns|Super Columns|
Super Golf|Super Golf|Super Golf|Super Golf|
Super Kick Off|Super Kick Off|Super Kick Off|Super Kick Off|
Superman: The Man of Steel|Superman|Superman - The Man of Steel|Superman|
Super Momotarō Densetsu III||Super Momotarou Dentetsu III|Super Momotarou Dentetsu III|
Super Monaco GP|Super Monaco GP|Super Monaco GP|Super Monaco GP|
Super Off-Road|Super Off-Road|Super Off Road|Super Off Road|
Super Smash T.V.|Super Smash T.V.|Super Smash T.V.|Smash T.V.|
Super Space Invaders|Super Space Invaders|Super Space Invaders|Super Space Invaders|
Super Star Wars: Return of the Jedi|Super Return of the Jedi|Super Return of the Jedi|Super Star Wars - Return of the Jedi|
Super Tetris|Super Tetris|||
Surf Ninjas|Surf Ninjas|Surf Ninjas|Surf Ninjas|
Sylvan Tale|Sylvan Tale|Sylvan Tale|Sylvan Tale|
T2: The Arcade Game|T2 - The Arcade Game|T2 - The Arcade Game|T2 - The Arcade Game|
Tails' Adventure|Tails' Adventures|Tails Adventures|Tails Adventures|
Tails' Sky Patrol|Tails' Sky Patrol|Tails' Skypatrol|Tails' Skypatrol|
Taisen-gata Daisenryaku G|Taisen-gata Daisenryaku G|Taisen-gata Daisenryaku G|Taisen-gata Daisenryaku G|
Taisen Mahjong HaoPai 2|Taisen Mahjong HaoPai 2|Taisen Mahjong HaoPai 2|Taisen Mahjong Hao-Pai 2|
Taisen Mahjong HaoPai|Taisen Mahjong HaoPai|Taisen Mahjong HaoPai|Taisen Mahjong Hao-Pai|
Tale Spin|Tale Spin|Tale Spin|Tale Spin|
Tama & Friends: 3choume Kouen: Tamalympics|Tama & Friends - 3choume Kouen - Tamalympics|Tama & Friends Sanchoume Kouen - Tamalympic|Tama & Friends - 3choume Kouen - Tamalympics|
Tarzan: Lord of the Jungle||Tarzan - Lord of the Jungle|Tarzan|
Tatakae! Pro Yakyuu Twin League||Tatakae! Pro Yakyuu Twin League|Tatakae! Pro Yakyuu Twin League|
Taz in Escape from Mars|Taz in Escape from Mars|Taz in Escape from Mars|Taz in Escape from Mars|
Taz-Mania: The Search for the Lost Seabirds|Taz-Mania - The Search for the Lost Seabirds|Taz-Mania - The Search for the Lost Seabirds|Taz-Mania - The Search for the Lost Seabirds|
Tempo Jr.|Tempo Jr.|Tempo Jr.|Tempo Jr.|
Tengen World Cup Soccer|World Cup Soccer|Tengen World Cup Soccer|Tengen World Cup Soccer|
Terminator 2: Judgment Day|Terminator 2 - Judgment Day|Terminator 2 - Judgment Day|Terminator 2 - Judgment Day|
Tesserae|Tesserae|Tesserae|Tesserae|
The Addams Family|Addams Family, The|Addams Family, The|Addams Family, The|
The Adventures of Batman & Robin|Adventures of Batman & Robin, The|Adventures of Batman & Robin, The|Adventures of Batman & Robin, The|
The Berenstain Bears' Camping Adventure|Berenstain Bears', The - Camping Adventure|Berenstain Bears' Camping Adventure, The|Berenstain Bears', The - Camping Adventure|
The Chessmaster|Chessmaster, The|Chessmaster, The|Chessmaster, The|
The Excellent Dizzy Collection|Excellent Dizzy Collection, The|Excellent Dizzy Collection, The|Excellent Dizzy Collection, The|
The Incredible Crash Dummies|Incredible Crash Dummies, The|Incredible Crash Dummies, The|Incredible Crash Dummies, The|
The Incredible Hulk|Incredible Hulk, The|Incredible Hulk, The|Incredible Hulk, The|
The Itchy & Scratchy Game|Itchy & Scratchy Game, The|Itchy & Scratchy Game, The|Itchy & Scratchy Game, The|
The Lost World: Jurassic Park|Lost World, The - Jurassic Park|Lost World, The - Jurassic Park|Lost World, The - Jurassic Park|
The Lucky Dime Caper Starring Donald Duck|Lucky Dime Caper, The Starring Donald Duck|Lucky Dime Caper, The|Lucky Dime Caper Starring Donald Duck, The|
The Majors Pro Baseball|Majors Pro Baseball, The|Majors Pro Baseball, The|Majors Pro Baseball, The|
The Ottifants|Ottifants, The|Ottifants, The|Ottifants, The|
The Pro Yakyuu '91|Pro Yakyuu '91, The|Pro Yakyuu '91, The|Pro Yakyuu '91, The|
The Quest for the Shaven Yak starring Ren Hoëk & Stimpy|Ren & Stimpy - Quest for the Shaven Yak, The|Quest for the Shaven Yak Starring Ren Hoek & Stimpy|Quest for the Shaven Yak Starring Ren Hoek & Stimpy|
The Quiz Gear Fight!!|Quiz Gear Fight!!, The|Quiz Gear Fight!!, The|Quiz Gear Fight!!, The|
The Simpsons: Bartman Meets Radioactive Man|Simpsons, The - Bartman Meets Radioactive Man|Bartman Meets Radioactive Man|Bartman Meets Radioactive Man|
The Simpsons: Bart vs. the Space Mutants|Simpsons, The - Bart vs. The Space Mutants|Simpsons, The - Bart vs. The Space Mutants|Simpsons, The - Bart vs. The Space Mutants|
The Simpsons: Bart vs. the World|Simpsons, The - Bart vs. The World|Simpsons, The - Bart vs. The World|Simpsons, The - Bart vs. The World|
The Smurfs|Smurfs, The|Smurfs, The||
The Smurfs Travel the World||Smurfs Travel the World, The||
The Terminator|Terminator, The|Terminator, The|Terminator, The|
Tintin in Tibet|Tintin au Tibet|Tintin in Tibet|Tintin in Tibet|
Tom and Jerry: The Movie|Tom and Jerry - The Movie|Tom and Jerry - The Movie|Tom and Jerry - The Movie|
Torarete Tamaruka!?|Torarete Tamaruka!|Torarete Tamaruka|Torareta Tamaruka!|
True Lies|True Lies|True Lies|True Lies|
Twisty|Twisty by Charles MacDonald|||
Ultimate Soccer|Ultimate Soccer|Ultimate Soccer|Ultimate Soccer|
Urban Strike|Urban Strike|Urban Strike|Urban Strike|
Vampire: Master of Darkness|Vampire - Master of Darkness|Vampire - Master of Darkness|Vampire - Master of Darkness|
Virtua Fighter Animation|Virtua Fighter Animation|Virtua Fighter Animation|Virtua Fighter Animation|
Virtua Fighter Mini|Virtua Fighter Mini|Virtua Fighter Mini|Virtua Fighter Mini|
Wagyan Land|Wagyan Land|Wagan Land|Wakiyarando|
Wheel Of Fortune: Featuring Vanna White|Wheel of Fortune|Wheel of Fortune|Wheel of Fortune|
Wimbledon|Wimbledon|Wimbledon|Wimbledon|
Windows for GG|Windows for GG by Victor Kemp|||
Winter Olympics: Lillehammer '94|Winter Olympics - Lillehammer '94|Winter Olympics - Lillehammer '94|XVII Olympic Winter Games, The - Lillehammer 1994|
Wizard Pinball|Wizard Pinball|Wizard Pinball|Wizard Pinball|
Wolfchild|Wolfchild|Wolfchild|Wolfchild|
Wonder Boy III: The Dragon's Trap|Wonder Boy - The Dragon's Trap|Wonder Boy III - The Dragon's Trap|Wonder Boy - The Dragon's Trap|
Wonder Boy|||Wonder Boy Rev 2|
Wonder Boy|Wonder Boy|Wonder Boy|Wonder Boy|
Woody Pop|Woody Pop|Woody Pop|Woody Pop|
World Class Leader Board|World Class Leader Golf|World Class Leader Board|World Class Leader Board|
World Cup USA 94|World Cup 94|World Cup USA 94|World Cup USA 94|
World Derby|World Derby|World Derby|World Derby|
World Series Baseball '95|World Series Baseball '95|World Series Baseball '95|World Series Baseball '95|
World Series Baseball|World Series Baseball|World Series Baseball|World Series Baseball|
WWF Raw|WWF Raw|WWF Raw|WWF Raw|
WWF Wrestlemania: Steel Cage Challenge|WWF Steel Cage Challenge|WWF Wrestlemania Steel Cage Challenge|WWF WrestleMania Steel Cage Challenge|
Xaropinho|Xaropinho|||
X-Men: Gamesmaster's Legacy|X-Men - Gamemaster's Legacy|X-Men - Gamemaster's Legacy|X-Men - Gamemaster's Legacy|
X-Men: Mojo World|X-Men - Mojo World|X-Men - Mojo World|X-Men - Mojo World|
X-Men|X-Men|X-Men|X-Men|
Yogi Bear in Yogi Bear's Goldrush|Yogi Bear in Yogi Bear's Goldrush|Yogi Bear in Yogi Bear's Goldrush|Yogi Bear in Yogi Bears Goldrush|
Yū Yū Hakusho II: Gekitou! Nanakyou no Tatakai|Yuu Yuu Hakusho II|Yu Yu Hakusho - Gekitou! Nanakyou no Tatakai|Yuu Yuu Hakusho II|
Yū Yū Hakusho|Yuu Yuu Hakusho|Yu Yu Hakusho|Yuu Yuu Hakusho|
Zan Gear|Zan Gear|Zan Gear|Zan Gear|
Zool: Ninja of the "Nth" Dimension|Zool|Zool|Zool|
Zoop'em Up|Zoop'em Up by Martin Konrad||Zoop'em Up|
Zoop|Zoop|Zoop|Zoop|
