1941: Counter Attack|1941 - Counter Attack||1941 - Counter Attack|
1943 Kai|1943 Kai|1943 Kai|1943 Kai|
21 Emon: Mezase Hotel ou!!|21-Emon - Mezase Hotel Ou!!|21 Emon - Mezase Hotel Ou!!||
Adventure Island|Adventure Island|Adventure Island|Adventure Island|
Aero Blasters|Aero Blasters|Aero Blasters||
After Burner II|After Burner II|After Burner II|After Burner II|
Air Zonk|Air Zonk|Air Zonk|Air Zonk|
Alien Crush|Alien Crush|Alien Crush|Alien Crush|
Ankoku Densetsu|Ankuku Densetsu|Ankoku Densetsu|Ankoku Densetsu|
Aoi Blink|Aoi Blink|Aoi Blink||
Appare! Gateball|Appare Gateball|Appare Gateball||
Armed Formation F|Armed Formation F|Armed Formation F||
Artist Tool|Artist Tool|Artist Tool||
Atomic Robo-Kid Special|Atomic Robo-Kid Special|Atomic Robo-Kid Special||
AV Poker|Av Poker|AV Poker||
Ballistix|Ballistix|Ballistix||
Bari Bari Densetsu|Bari Bari Densetsu|Bari Bari Densetsu||
Barunba|Barunba|Barunba||
Batman: The Video Game|Batman|Batman||
Battle Lode Runner|Battle Lode Runner|Battle Lode Runner||
Battle Royale|Battle Royale|Battle Royale||
Be Ball|Be Ball|Be Ball||
Bikkuriman World|Bikkuriman World|Bikkuriman World||
Blazing Lazers|Blazing Lazers|Blazing Lazers||
Blodia|Blodia|Blodia||
Bloody Wolf|Bloody Wolf|Bloody Wolf||
Body Conquest II|Body Conquest II|Body Conquest II||
Bôken Danshaku Don: The Lost Sunheart|Bouken Danshaku Don - The Lost Sunheart|Bouken Danshaku Don - The Lost Sunheart||
Bomberman '93|Bomberman '93|Bomberman '93||
Bomberman '94|Bomberman '94|Bomberman '94||
Bomberman|Bomberman|Bomberman||
Bomberman: Users Battle|Bomberman Users Battle|Bomberman - Users Battle||
Bonk 3: Bonk's Big Adventure|Bonk III - Bonk's Big Adventure|Bonk III - Bonk's Big Adventure||
Bonk's Adventure|Bonk's Adventure|Bonk's Adventure||
Bonk's Revenge|Bonk's Revenge|Bonk's Revenge||
Boxyboy|Boxy Boy|Boxyboy||
Bravoman|Bravoman|Bravoman||
Break In|Break In|Break In||
Bubblegum Crash!: Knight Sabers 2034|Bubblegum Crash! - Knight Sabers 2034|Bubblegum Crash! - Knight Sabers 2034||
Bullfight: Ring no Hasha|Bullfight - Ring no Hasha|Bull Fight - Ring no Haja||
Burning Angels|Burning Angels|Burning Angels||
Busou Keiji: Cyber Cross|Busou Keiji Cyber Cross|Busou Keiji - Cyber Cross||
Cadash|Cadash|Cadash||
Champions Forever Boxing|Champions Forever Boxing|Champions Forever Boxing||
Champion Wrestler|Champion Wrestler|Champion Wrestler||
Chew Man Fu|Chew Man Fu|Chew Man Fu||
Chibi Maruko-Chan: Quiz de Piihyara|Chibi Maruko-Chan Quiz de Pihyara|Chibi Maruko Chan - Quiz de Piihyara||
Chikudenya Toubei: Kubikiri Yakata Yori|Chikuden Yatoubei - Kubikiri Yakata Yori|Chikudenya Toubei - Kubikiri Yakata Yori||
Chouzetsu Rinjin: Bravoman|Chouzetsu Rinjin Berabou Man|Chouzetsu Rinjin - Bravoman||
Circus Lido||Circus Lido||
City Hunter|City Hunter|City Hunter||
Columns|Columns|Columns||
Coryoon: Child of Dragon|Coryoon - Child of Dragon|Coryoon - Child of Dragon||
Cratermaze|Cratermaze|Cratermaze||
Cross Wiber: Cyber Combat Police|Cross Wiber - Cyber Combat Police|Cross Wiber - Cyber Combat Police||
Cyber-Core|Cyber Core|Cyber Core||
Cyber Dodge||Cyber Dodge||
Cyber Knight|Cyber Knight|Cyber Knight||
Daichikun Crisis: Do Natural|Daichikun Crisis|Daichi-kun Crisis - Do Natural||
Daisenpu||Dai Senpu||
Darius Alpha|Darius Alpha|Darius Alpha||
Darius Plus|Darius Plus|Darius Plus||
Davis Cup Tennis||Davis Cup Tennis||
Dead Moon|Dead Moon|Dead Moon||
Deep Blue: Kaitei Shinwa|Deep Blue - Kaitei Shinwa|Deep Blue||
Detana!! Twin Bee|Detana!! TwinBee|Detana!! TwinBee||
Devil Crash|Devil Crash|Devil Crash - Naxat Pinball||
Devil's Crush|Devil's Crush|Devil's Crush - Naxat Pinball||
Die Hard|Die Hard|Die Hard||
Digital Champ|Digital Champ|Digital Champ||
Disney's Darkwing Duck|Darkwing Duck|Darkwing Duck||
Disney's TaleSpin|TaleSpin|TaleSpin||
Don Doko Don!|Don Doko Don|Don Doko Don!||
Doraemon: Meikyū Daisakusen|Doraemon - Meikyuu Daisakusen|Doraemon - Meikyuu Dai Sakusen||
Doraemon: Nobita no Dorabian Night|Doraemon - Nobita no Dorabian Night|Doraemon - Nobita no Dorabian Night||
Double Dungeons|Double Dungeons|Double Dungeons - W||
Download|Download|Download||
Dragon Egg!|Dragon Egg!|Dragon Egg!||
Dragon Saber: After Story of Dragon Spirit|Dragon Saber - After Story of Dragon Spirit|Dragon Saber - After Story of Dragon Spirit||
Dragon's Curse|Dragon's Curse|Dragon's Curse||
Dragon Spirit|Dragon Spirit|Dragon Spirit||
Drop.Off|Drop Off|Drop.Off||
Drop Rock Hora Hora|Drop Rock Hora Hora|Drop Rock Hora Hora||
Dungeon Explorer|Dungeon Explorer|Dungeon Explorer||
Energy|Energy|Energy||
F1 Circus '91: World Championship|F1 Circus '91 - World Championship|F1 Circus '91 - World Championship||
F1 Circus '92: The Speed of Sound|F1 Circus '92 - The Speed of Sound|F1 Circus '92 - The Speed of Sound||
F1 Circus|F1 Circus|F1 Circus||
F-1 Dream|F-1 Dream|F-1 Dream||
F-1 Pilot: You're King of Kings|F-1 Pilot - You're King of Kings|F-1 Pilot - You're King of Kings||
F1 Triple Battle|F1 Triple Battle|F1 Triple Battle||
Falcon||Falcon||
Fantasy Zone|Fantasy Zone|Fantasy Zone||
Fighting Run|Fighting Run|Fighting Run||
Final Blaster|Final Blaster|Final Blaster||
Final Lap Twin|Final Lap Twin|Final Lap Twin||
Final Match Tennis|Final Match Tennis|Final Match Tennis||
Final Soldier|Final Soldier|Final Soldier||
Fire Pro Wrestling 2nd Bout|Fire Pro Wrestling - 2nd Bout|Fire Pro Wrestling 2 - 2nd Bout||
Fire Pro Wrestling 3: Legend Bout|Fire Pro Wrestling 3 - Legend Bout|Fire Pro Wrestling 3 - Legend Bout||
Fire Pro Wrestling: Combination Tag|Fire Pro Wrestling - Combination Tag|Fire Pro Wrestling - Combination Tag||
Formation Armed F|Armed Formation F|Armed Formation F||
Formation Soccer: Human Cup '90|Formation Soccer - Human Cup '90|Formation Soccer - Human Cup '90||
Formation Soccer: On J. League|Formation Soccer on J. League|Formation Soccer - On J. League||
Fushigi no Yume no Alice|Fushigi no Yume no Alice|Fushigi no Yume no Alice||
Gaia no Monshō|Gaia no Monshou|Gaia no Monshou||
GaiFlame|Gai Flame|Gai Flame||
Galaga '88|Galaga '88|Galaga '88||
Galaga '90|Galaga '90|Galaga '90||
Games Express CD Card|Games Express CD Card 1993|Games Express CD Card||
Ganbare! Golf Boys|Ganbare Golf Boys|Ganbare! Golf Boys||
Gekisha Boy|Gekisha Boy|Gekisha Boy||
Genji Tsuushin Agedama|Genji Tsuushin Agedama|Genji Tsuushin Agedama||
Genpei Tōma Den|Genpei Toumaden|Genpei Toumaden||
Genpei Toumaden ni no Maki||Genpei Toumaden Ni no Maki||
Ghost Manor||Ghost Manor||
Gokuraku! Chuka Taisen|Gokuraku! Chuuka Taisen|Gokuraku! Chuuka Taisen||
Gomola Speed||Gomola Speed||
Gradius|Gradius|Gradius||
Gunboat|Gunboat|Gunboat||
Gunhed|Gunhed|Gunhed||
Gunhed Taikai|Gunhed Taikai|Gunhed - Hudson Gunhed Taikai||
Hana Tāka Daka!? |Hana Taka Daka!|Hana Taaka Daka!||
Haniy on the Road||Hanii on the Road||
Hany in the Sky||Hanii in the Sky||
Hatris|Hatris|Hatris||
Heavy Unit|Heavy Unit|Heavy Unit||
Hisõ Kihei X Serd|Hisou Kihei X Serd|Hisou Kihei - Xserd||
Hit the Ice: VHL The Official Video Hockey League|Hit the Ice - VHL - The Video Hockey League|Hit the Ice - VHL the Official Video Hockey League||
Honey in the Sky|Honey in the Sky|||
Honey on the Road|Honey on the Road|||
Honō no Tōkyūji: Dodge Danpei||Honoo no Toukyuuji Dodge Danpei||
Idol Hanafuda Fan Club|Idol Hanafuda Fan Club|Idol Hanafuda Fan Club||
Image Fight|Image Fight|Image Fight||
Impossamole|Impossamole|Impossamole||
Jackie Chan||Jackie Chan||
Jackie Chan's Action Kung Fu|Jackie Chan's Action Kung Fu|Jackie Chan's Action Kung Fu||
Jack Nicklaus' Greatest 18 Holes of Major Championship Golf|Jack Nicklaus' Greatest 18 Holes of Major Champ. Golf|Jack Nicklaus' Greatest 18 Holes of Major Championship Golf||
Jack Nicklaus' Turbo Golf|Jack Nicklaus' Turbo Golf|Jack Nicklaus' Turbo Golf||
Jaseiken Necromancer|Necromancer|Necromancer||
Jigoku Meguri|Jigoku Meguri|Jigoku Meguri||
Jinmu Denshō|Jinmu Denshou|Jinmu Denshou||
J.J. & Jeff|J.J. & Jeff|J.J. & Jeff||
J. League Greatest Eleven|J. League Greatest Eleven|J. League Greatest Eleven||
Juuouki|Juuouki|Juuouki||
Kaizō Chōjin Shubibinman|Kaizou Choujin Shubibinman|Kaizou Choujin Shubibinman||
Kaizou Choujin Shubibinman 2: Aratanaru Teki|Kaizou Choujin Shubibinman 2 - Aratanaru Teki|Kaizou Choujin Shubibinman 2 - Aratanaru Teki||
Kato Chan & Ken Chan|Kato Chan & Ken Chan|Kato Chan & Ken Chan||
Kattobi! Takuhai Kun|Kattobi! Takuhaikun|Kattobi! Takuhai Kun||
Keith Courage in Alpha Zones|Keith Courage in Alpha Zones|Keith Courage in Alpha Zones|Keith Courage in Alpha Zones|
KickBall|Kick Ball|KickBall||
KiKi KaiKai|Kiki Kaikai|Kikikai-kai||
King of Casino|King of Casino|King of Casino||
Klax|Klax|Klax||
Knight Rider Special|Knight Rider Special|Knight Rider Special||
Kore ga Pro Yakyuu '89|Kore ga Pro Yakyuu '89|Kore ga Pro Yakyuu '89||
Kore ga Pro Yakyuu '90|Kore ga Pro Yakyuu '90|Kore ga Pro Yakyuu '90||
Kyuukyoku Mahjong Idol Graphic II|Kyuukyoku Mahjong Idol Graphic II|Kyuukyoku Mahjong II||
Kyuukyoku Mahjong: Idol Graphic|Kyuukyoku Mahjong Idol Graphic|Kyuukyoku Mahjong - Idol Graphics||
Kyuukyoku Tiger|Kyuukyoku Tiger|Kyuukyoku Tiger||
Lady Sword|Lady Sword|Lady Sword||
Legend of Hero Tonma|Legend of Hero Tonma|Legend of Hero Tonma||
Lode Runner: Lost Labyrinth|Lode Runner - Lost Labyrinth|Lode Runner - Lost Labyrinth||
Magical Chase|Magical Chase|Magical Chase||
Mahjong Gakuen Mild: Touma Soushirou Toujou|Mahjong Gakuen Mild - Touma Soujirou Toujou|Mahjong Gakuen Mild - Touma Soushirou Toujou||
Mahjong Gakuen: Touma Soushirou Toujou|Mahjong Gakuen - Toumasou Shirou Toujou|Mahjong Gakuen - Touma Soushirou Toujou||
Mahjong Gokuu Special||Mahjong Gokuu Special||
Mahjong Haou Den: Kaiser's Quest||Mahjong Haou Den - Kaiser's Quest||
Mahjong Shikyaku Retsuden: Mahjong Wars||Mahjong Shikyaku Retsuden - Mahjong Wars||
Maison Ikkoku|Maison Ikkoku|Maison Ikkoku||
Majin Eiyuu Den Wataru||Majin Eiyuu Den Wataru||
Makai Hakkenden Shada|Makai Hakkenden Shada|Makai Hakken Den Shada||
Makai Prince Dorabocchan|Makai Prince Dorabocchan|Makai Prince Dorabocchan||
Makyou Densetsu|Makyou Densetsu - The Legendary Axe|Makyou Densetsu||
Maniac Puroresu: Asu heno Tatakai|Maniac Pro Wrestling - Asu he no Tatakai|Maniac Puroresu - Asu e no Tatakai||
Marchen Maze|Marchen Maze|Maerchen Maze||
Mesopotamia|Mesopotamia|Mesopotamia||
Metal Stoker|Metal Stoker|Metal Stoker||
Military Madness|Military Madness|Military Madness||
Mizubaku Daibouken|Mizubaku Daibouken|Mizubaku Dai Bouken||
Momotarō Densetsu Gaiden|Momotarou Densetsu Gaiden - Dai 1 Shuu|Momotarou Densetsu Gaiden Dai 1 Shuu||
Momotarō Densetsu II|Momotarou Densetsu II|Momotarou Densetsu II||
Momotarō Densetsu Turbo|Momotarou Densetsu Turbo|Momotarou Densetsu Turbo||
Momotarō Katsugeki|Momotarou Katsugeki|Momotarou Katsugeki||
Monster Puroresu|Monster Pro Wrestling|Monster Puroresu||
Morita Shougi PC|Morita Shougi PC|Morita Shougi PC||
Moto Roader II|Moto Roader II|Moto Roader II||
Moto Roader|Moto Roader|Moto Roader||
Mr. HELI no Daibouken|Mr. Heli no Daibouken|Mr. Heli no Daibouken||
Name|GoodName|NoIntro|TOSEC|ReDump
Narazumono Sentai Butai: Bloody Wolf|Narazumo no Sentou Butai Bloody Wolf|Narazumono Sentai Butai - Bloody Wolf||
Naxat Open|Naxat Open|Naxat Open||
Naxat Stadium|Naxat Stadium|Naxat Stadium||
Nazo no Mascarade|Nazo no Masquerade|Nazo no Mascarade||
Necros no Yōsai|Necros no Yousai|Necros no Yousai||
Nekketsu Koukou Dodgeball Bu: PC Bangai Hen|Nekketsu Koukou Dodgeball Bu PC Bangai Hen|Nekketsu Koukou Dodgeball-bu - PC Bangai Hen||
Nekketsu Koukou Dodgeball Bu: Soccer PC Hen|Nekketsu Koukou Dodgeball Bu PC Soccer Hen|Nekketsu Koukou Dodgeball Bu - Soccer PC Hen||
Neo Nectaris|Nectaris|Nectaris||
Neutopia II|Neutopia II|Neutopia II||
Neutopia|Neutopia|Neutopia||
New Adventure Island|New Adventure Island|New Adventure Island||
NHK Taiga Drama: Taiheiki|NHK Taiga Drama Taiheiki|NHK Taiga Drama - Taiheiki||
Night Creatures|Night Creatures|Night Creatures||
Niko Niko Pun||Niko Niko Pun||
Ninja Gaiden|Benkei Gaiden|Benkei Gaiden||
Ninja Ryuuken Den|Ninja Ryukenden|Ninja Ryuuken Den||
Ninja Spirit|Ninja Spirit|Ninja Spirit||
Obocchama-kun|Obocchamakun|Obocchama Kun||
Operation Wolf|Operation Wolf|Operation Wolf||
Order of the Griffon|Order of the Griffon|Order of the Griffon||
Ordyne|Ordyne|Ordyne||
Out Live|Out Live - It's Far a Future on Planet|Out Live||
Out Run|OutRun|Out Run||
Override|Override - Mission Code -Override-|Override||
P-47 - The Freedom Fighter|P-47 - The Freedom Fighter|P-47 - The Freedom Fighter||
Pachio Kun: Juuban Shoubu|Pachiokun Juuban Shoubu|Pachio Kun - Juuban Shoubu||
Pac-Land|Pac-Land|Pac-Land||
Panza Kick Boxing|Panza Kick Boxing|Panza Kick Boxing||
Paranoia|Paranoia|Paranoia||
Parasol Stars: The Story of Bubble Bobble III|Parasol Stars - The Story of Bubble Bobble III|Parasol Stars - The Story of Bubble Bobble III||
Parodius DA!|Parodius Da! - Shinwa kara Owarai he|Parodius da! - Shinwa Kara Owarai he||
PC Denjin: Punkic Cyborgs|PC Denjin - Punkic Cyborgs|PC Denjin - Punkic Cyborgs||
PC Genjin 2: Pithecanthropus Computerurus|PC Genjin 2 - Pithecanthropus Computerurus|PC Genjin 2 - Pithecanthropus Computerurus||
PC Genjin 3: Pithecanthropus Computerurus|PC Genjin 3 - Pithecanthropus Computerurus|PC Genjin 3 - Pithecanthropus Computerurus||
PC Genjin: Pithecanthropus Computerurus|PC Genjin - Pithecanthropus Computerurus|PC Genjin - Pithecanthropus Computerurus||
PC Pachi-Slot|PC Pachi-Slot 777|PC Pachi-Slot||
Populous|Populous|Populous||
Power Drift|Power Drift|Power Drift||
Power Eleven|Power Eleven|Power Eleven||
Power Gate|Power Gate|Power Gate||
Power Golf|Power Golf|Power Golf||
Power League '93|Power League '93|Power League '93||
Power League III|Power League III|Power League III||
Power League II|Power League II|Power League II||
Power League IV|Power League IV|Power League IV||
Power League|Power League|Power League||
Power League V|Power League V|Power League V||
Power Sports|Power Sports|Power Sports||
Power Tennis|Power Tennis|Power Tennis||
Pro Tennis World Court|Pro Tennis World Court|Pro Tennis World Court||
Pro Yakyuu World Stadium '91|Pro Yakyuu World Stadium '91|Pro Yakyuu World Stadium '91||
Pro Yakyuu World Stadium|Pro Yakyuu World Stadium|Pro Yakyuu World Stadium||
Psycho Chaser|Psycho Chaser|Psycho Chaser||
Psychosis|Psychosis|Psychosis||
Puzzle Boy|Puzzle Boy|Puzzle Boy||
Puzznic|Puzznic|Puzznic||
Quiz Toukou Shashin|Quiz Toukou Shashin|Quiz Toukou Shashin||
Rabio Lepus Special|Rabio Lepus Special|Rabio Lepus Special||
Racing Damashii|Racing Damashii|Racing Damashii||
Raiden|Raiden|Raiden||
Rastan Saga II|Rastan Saga II|Rastan Saga II||
Rock-On|Rock On|Rock-On||
R-Type: Part 1||R-Type Part-1||
R-Type: Part 2|R-Type Part-2|R-Type Part-2||
R-Type|R-Type|R-Type||
Ryuukyuu|Ryuukyuu|Ryuukyuu||
Sadakichi Nanaban Series Hideyoshi no Ougon|Sadakichi Nanaban Series Hideyoshi no Ougon|Sadakichi 7 Series - Hideyoshi no Ougon||
Saigo no Nindou: Ninja Spirit|Saigo no Nindou - Ninja Spirit|Saigo no Nindou - Ninja Spirit||
Salamander|Salamander|Salamander||
Samurai Ghost|Samurai Ghost|Samurai-Ghost||
Sekigahara|Sekigahara|Sekigahara||
Sengoku Mahjong|Sengoku Mahjong|Sengoku Mahjong||
Shanghai|Shanghai|Shanghai||
Shinobi|Shinobi|Shinobi||
Shiryou Sensen|Shiryou Sensen|Shiryou Sensen||
Shockman|ShockMan|Shockman||
Shougi Shodan Icchokusen|Shougi Shodan Icchokusen|Shougi Shodan Icchokusen||
Shougi Shoshinsha Muyou|Shougi Shoshinsha Muyou|Shougi Shoshinsha Muyou||
Side Arms Hyper Dyne|Side Arms - Hyper Dyne|SideArms - Hyper Dyne||
Silent Debuggers|Silent Debuggers|Silent Debuggers||
Sindibad: Chitei no Daimakyū |Sindibad - Chitei no Daimakyuu|Sindibad Chitei no Dai Makyuu||
Sinistron|Sinistron|Sinistron||
Skweek|Skweek|Skweek||
Soldier Blade|Soldier Blade|Soldier Blade||
Soldier Blade Special: Caravan Stage|Soldier Blade Special - Caravan Stage|Soldier Blade Special - Caravan Stage||
Somer Assault|Somer Assault|Somer Assault||
Sonic Spike|Sonic Spike - World Championship Beach Volleyball|Sonic Spike - World Championship Beach Volleyball||
Son Son II|Son Son II|Son Son II||
Soukoban World|Soukoban World|Soukoban World||
Space Harrier|Space Harrier|Space Harrier||
Space Invaders: Fukkatsu no Hi|Space Invaders - Fukkatsu no Hi|Space Invaders - Fukkatsu no Hi||
Special Criminal Investigation|S.C.I. - Special Criminal Investigation|Special Criminal Investigation||
Spin Pair|Spin Pair|Spin Pair||
Spiral Wave|Spiral Wave|Spiral Wave||
Splatterhouse|Splatterhouse|Splatterhouse||
Stratego|Stratego|Stratego||
Street Fighter II': Special Champion Edition|Street Fighter II' - Champion Edition|Street Fighter II' - Champion Edition||
Strip Fighter II|Strip Fighter II|Strip Fighter II||
Super CD-ROM System|Super CD-ROM2 System V3.00|Super CD-ROM System||
Super Metal Crusher|Super Metal Crusher|Super Metal Crusher||
Super Momotarō Densetsu II|Super Momotarou Dentetsu II|Super Momotarou Dentetsu II||
Super Momotarō Densetsu|Super Momotarou Dentetsu|Super Momotarou Dentetsu||
Super Star Soldier|Super Star Soldier|Super Star Soldier||
Super Volleyball|Super Volley Ball|Super Volleyball||
Susanoō Densetsu|Susanoou Densetsu|Susanoo Densetsu||
Taito Chase H.Q.|Taito Chase H.Q.|Taito Chase H.Q.||
Takahashi Meijin no Shin Boukenjima|Takahashi Meijin no Shin Bouken Jima|Takahashi Meijin no Shin Boukenjima||
Takeda Shingen|Takeda Shingen|Takeda Shingen||
Takin' It to the Hoop|Takin' It to the Hoop|Takin' It to the Hoop||
Tatsujin|Tatsujin|Tatsujin||
Tatsunoko Fighter|Tatsu no Ko Fighter|Tatsunoko Fighter||
Tennokoe Bank||Tennokoe Bank||
Tenseiryuu: Saint Dragon|Tenseiryuu - Saint Dragon|Tenseiryuu - Saint Dragon||
Terra Cresta II: Mandoraa no Gyakushuu|Terra Cresta II - Mandrer no Gyakushuu|Terra Cresta II - Mandoraa no Gyakushuu||
The Kung Fu||Kung Fu, The||
The Legendary Axe II|Legendary Axe II, The|Legendary Axe II, The||
The Legendary Axe|Legendary Axe, The|Legendary Axe, The||
The New Zealand Story|New Zealand Story, The|New Zealand Story, The||
The Ninja Warriors|Ninja Warriors, The|Ninja Warriors, The||
The Tower of Druaga|Tower of Druaga, The - Druaga no Tou|Tower of Druaga, The||
Thunder Blade|Thunder Blade|Thunder Blade||
Tiger Road|Tiger Road|Tiger Road||
Timeball|Timeball|Timeball||
Time Cruise II|Time Cruise II|Time Cruise II||
Time Cruise|Time Cruise|Time Cruise||
Titan|Titan|Titan||
Toilet Kids|Toilet Kids|Toilet Kids||
Tora heno Michi|Tora eno Michi - Tiger Road|Tora heno Michi||
Toshi Tensou Keikaku: Eternal City|Toshi Tensou Keikaku - Eternal City|Toshi Tensou Keikaku - Eternal City||
Toy Shop Boys|Toy Shop Boys|Toy Shop Boys||
Tricky Kick|Tricky Kick|Tricky Kick||
Tricky|Tricky|Tricky||
Tsuppari Oozumou: Heisei Ban|Tsuppari Oozumo - Heiseiban|Tsuppari Oozumou - Heisei Ban||
Tsuru Teruhito no Jissen Kabushiki Bai Bai Game|Tsuru Teruhito no Jissen Kabushiki Bai Bai Game|Tsuru Teruhito no Jissen Kabushiki Bai Bai Game||
Turrican|Turrican|Turrican||
TV Sports: Basketball|TV Sports Basketball|TV Sports Basketball||
TV Sports: Football|TV Sports Football|TV Sports Football||
TV Sports Hockey|TV Sports Hockey|TV Sports Hockey||
Usagi no Kuni no Kangaroo Race Wallaby!!|Usagi no Kuni no Kangaroo Race Wallaby!!|Wallaby!! - Usagi no Kuni no Kangaroo Race||
USA Pro Basketball|USA Pro Basketball|USA Pro Basketball||
Valkyrie no Densetsu|Valkyrie no Densetsu|Walkuere no Densetsu||
Veigues: Tactical Gladiator|Veigues Tactical Gladiator|Veigues - Tactical Gladiator||
Victory Run|Victory Run|Victory Run||
Vigilante|Vigilante|Vigilante||
Volfied|Volfied|Volfied||
Wai Wai Mahjong: Yukaina Janyuu Tachi|Wai Wai Mahjong - Yukai na Janyuutachi|Wai Wai Mahjong - Yukaina Janyuu Tachi||
Winning Shot|Winning Shot|Winning Shot||
Wonder Momo|Wonder Momo|Wonder Momo||
World Beach Volley|World Beach Volley|World Beach Volley||
World Circuit|World Circuit|World Circuit||
World Class Baseball|World Class Baseball|World Class Baseball||
World Court Tennis|World Court Tennis|World Court Tennis||
World Jockey||World Jockey||
World Sports Competition|World Sports Competition|World Sports Competition||
W-Ring: The Double Rings|W Ring - The Double Rings|W-Ring - The Double Rings||
Xevious: Fardraut Densetsu|Xevious - Fardraut Densetsu|Xevious - Fardraut Densetsu||
Yo, Bro|Yo, Bro|Yo, Bro||
Yōkai Dōchūki|Youkai Douchuuki|Youkai Douchuuki||
Yuu Yuu Jinsei: Victory Life||Yuu Yuu Jinsei - Victory Life||
Zero4 Champ|Zero 4 Champ|Zero 4 Champ||
Zipang|Zipang|Zipang||
