2010: The Graphic Action Game|2010 - The Graphic Action Game|2010 - The Graphic Action Game|2010 - The Graphic Action Game|
6 Noises Demo|6 Noises Demo|||
Adamcon 17 (Demo)|Adamcon 17 Demo by Guy Foster and Daniel Bienvenu||Adamcon 17|
Adam's Musicbox (Demo)|Adam's Musicbox Demo|Adam's Musicbox Demo|Adam's Musicbox Demo|
Adventurium 3 (Demo)|Adventurium3 Demo|Adventurium 3 - Demo|Adventurium 3 Demo|
Air Battle|Air Battle V0.4 by Daniel Bienvenu|Air Battle by Daniel Bienvenu|Air Battle v0.4|
Alcazar: The Forgotten Fortress|Alcazar - The Forgotten Fortress|Alcazar - The Forgotten Fortress|Alcazar - The Forgotten Fortress|
Alphabet Zoo|Alphabet Zoo|Alphabet Zoo|Alphabet Zoo|
Amazing Bumpman|Amazing Bumpman|Amazing Bumpman|Amazing Bumpman|
Amazing Snake (Beta 4)|Amazing Snake Beta 4 by Serge-Eric Tremblay|Amazing Snake - Beta 4|Amazing Snake v0.4 (2000)(Tremblay, Serge-Eric)(PD)|
Amazing Snake (Beta 5)|Amazing Snake Beta 5 by Serge-Eric Tremblay|Amazing Snake - Beta 5|Amazing Snake v0.5 (2000)(Tremblay, Serge-Eric)(PD)|
Amazing Snake (Beta X)|Amazing Snake Beta X by Serge-Eric Tremblay|Amazing Snake - Beta X|Amazing Snake (2000)(Tremblay, Serge-Eric)(PD)|
Antarctic Adventure|Antarctic Adventure|Antarctic Adventure|Antarctic Adventure|
Aquattack|Aquattack|Aquattack|Aquattack|
Artillery Duel|Artillery Duel|Artillery Duel|Artillery Duel|
Astro Invader|Astro Invader|Astro Invader|Astro Invader|
Bankruptcy Builder|||Bankruptcy Builder|
BC's Quest for Tires|BC's Quest for Tires|BC's Quest for Tires|BC's Quest for Tires|
BC's Quest for Tires II: Grog's Revenge|BC's Quest for Tires II - Grog's Revenge|BC's Quest for Tires II - Grog's Revenge|BC's Quest for Tires II - Grog's Revenge|
Beamrider|Beamrider|Beamrider|Beamrider|
Bejeweled (Demo)|Bejeweled Demo by Daniel Bienvenu|Bejeweled Demo|Bejeweled|
Beyond Terra|||Beyond Terra|
Black Onyx|||Black Onyx|
Blockade Runner|Blockade Runner|Blockade Runner|Blockade Runner|
Boulder Dash|Boulder Dash|Boulder Dash|Boulder Dash|
Brain Strainers|Brain Strainers|Brain Strainers|Brain Strainers|
Breakout|Breakout by Daniel Bienvenu|Breakout|Breakout|
Breakout (Paddle demo)|Breakout Paddle Demo by Daniel Bienvenu|Breakout Paddle Demo|Breakout Paddle|
Buck Rogers: Planet of Zoom|Buck Rogers - Planet of Zoom|Buck Rogers - Planet Of Zoom|Buck Rogers - Planet of Zoom|
Bump 'n' Jump|Bump 'N' Jump (1982) (Data East)|Bump 'N' Jump (UE)|Bump 'n' Jump (1984)(Coleco)|
Bump 'n' Jump|Bump 'N' Jump (1982) (Mattel) (Prototype)|Bump 'N' Jump (UE) (Proto)|Bump 'n' Jump (1984)(Mattel)(proto)|
BurgerTime|Burgertime (1982) (Data East) [!]|Burgertime (UE)|Burgertime (1984)(Coleco)|
BurgerTime|Burgertime (1982) (Mattel) (Prototype)|Burgertime (UE) (Proto)|Burgertime (1983)(Mattel)(proto)|
BUsTin-Out (Demo)|BUsTin-Out Demo 0.5 by Daniel Bienvenu|BUsTin-Out Demo 0.5|BUSTin Out|
BUsTin-Out: Volume 0|BUsTin-Out Volume 0 by Daniel Bienvenu|BUsTin-Out Volume 0|BUSTin Out v0|
BUsTin-Out: Volume 1|BUsTin-Out Volume 1 by Daniel Bienvenu|BUsTin-Out Volume 1|BUSTin Out v1|
BUsTin-Out: Volume 2|BUsTin-Out Volume 2 by Daniel Bienvenu|BUsTin-Out Volume 2|BUSTin Out v2|
BUsTin-Out: Volume 3|BUsTin-Out Volume 3 by Daniel Bienvenu|BUsTin-Out Volume 3|BUSTin Out v3|
Cabbage Patch Kids: Adventures in the Park|Cabbage Patch Kids - Adventures in the Park|Cabbage Patch Kids - Adventure in the Park|Cabbage Patch Kids - Adventures in the Park|
Cabbage Patch Kids: Picture Show|Cabbage Patch Kids - Picture Show|Cabbage Patch Kids Picture Show|Cabbage Patch Kids Picture Show|
Campaign '84|Campaign '84|Campaign '84|Campaign '84|
Canadian Mini Games: 1|||Canadian Mini Games 1|
Carnival|Carnival|Carnival|Carnival|
Centipede|Centipede|Centipede|Centipede|
Chateau du Dragon|Chateau du Dragon, Le by Daniel Bienvenu|Le Chateau du Dragon|Chateau du Dragon, Le|
Choplifter!|Choplifter|Choplifter|Choplifter|
Christmas Demo|Christmas Demo by Daniel Bienvenu|Christmas Demo|Christmas|
Chuck Norris Superkicks|Chuck Norris - Super Kicks|Chuck Norris - Super Kicks|Chuck Norris Super Kicks|
ColecoVision Monitor Test|ColecoVision Monitor Test|ColecoVision Monitor Test|ColecoVision Monitor Test|
ColecoVision Noise Generator|ColecoVision Noise Generator by Marcel de Kogel|ColecoVision Noise Generator|ColecoVision Noise Generator|
Colecovision RPG Demo|Colecovision RPG Demo by Bruce Tomlin|Colecovision R.P.G. Demo|Colecovision RPG Demo|
Colored Gravity|||Colored Gravity|
Congo Bongo|Congo Bongo|Congo Bongo|Congo Bongo|
Conway's Game of Life|||Conway's Game of Life|
Cosmic Avenger|Cosmic Avenger|Cosmic Avenger|Cosmic Avenger|
Cosmic Crisis|Cosmic Crisis|Cosmic Crisis|Cosmic Crisis|
Cosmo Challenge|Cosmo Challenge by Marcel de Kogel|Cosmo Challenge|Cosmo Challenge|
Cosmo Challenge & Cosmo Trainer|Cosmo Challenge-Trainer Menu by Marcel de Kogel|Cosmo Challenge Trainer Menu|Cosmo Challenge & Cosmo Trainer|
Cosmo Fighter 2|Cosmo Fighter 2 by Marcel de Kogel|Cosmo Fighter 2|Cosmo Fighter 2|
Cosmo Fighter 3 (Demo)|Cosmo Fighter 3 Demo by Marcel de Kogel|Cosmo Fighter 3|Cosmo Fighter 3|
Cosmo Trainer|Space Trainer (2005) (Daniel Bienvenu) [a1]|Cosmo Trainer|Cosmo Trainer|
CVDrum (Demo)|CVDrum Demo|CVDrum Demo|CVDrum|
Dacman|Dacman by Daniel Bienvenu|Dacman|Dacman|
Dacman (Rev 1.2b)|Dacman V1.2b by Daniel Bienvenu|Dacman (Rev 1.2b)|Dacman V1.2b|
Dacman (Rev 20000717)|Dacman Rev 20000717|Dacman 20000717|Dacman Rev 20000717|
Dacman (Rev 20000727)|Dacman Rev 20000727|Dacman 20000727|Dacman Rev 20000727|
Dacman (Rev 20000808)|Dacman Rev 20000808|Dacman 20000808|Dacman Rev 20000808|
Dacman (Rev 20000816)|Dacman Rev 20000816|Dacman 20000816|Dacman Rev 20000816|
Dam Busters|Dam Busters, The|Dam Busters, The|Dam Busters, The|
Dance Fantasy|Dance Fantasy|Dance Fantasy|Dance Fantasy|
Death Race|Death Race|Death Race|Death Race|
Decathlon|Decathlon|Decathlon|Decathlon|
Defender|Defender|Defender|Defender|
Demon 2 (Demo)|Demon2 Demo by Yannick Proulx|Demon 2 Demo|Demon 2|
Destructor|Destructor|Destructor|Destructor|
Diamond Dash (4kb)|Diamond Dash 4kb by Daniel Bienvenu|Diamond Dash 4kb|Diamond Dash (2004)(Bienvenu, Daniel)(PD)[4k]|
Diamond Dash (8kb)|Diamond Dash 8kb by Daniel Bienvenu|Diamond Dash 8kb|Diamond Dash (2004)(Bienvenu, Daniel)(PD)[8k]|
Dig Dug|Dig Dug|Dig Dug|Dig Dug|
Donkey Kong Arcade|Donkey Kong Arcade|Donkey Kong Arcade|Donkey Kong Arcade|
Donkey Kong|Donkey Kong|Donkey Kong|Donkey Kong|
Donkey Kong|Donkey Kong for Adam|Donkey Kong (UE) (Adam)|Donkey Kong for Adam|
Donkey Kong Jr.|Donkey Kong Jr|Donkey Kong Jr|Donkey Kong Junior|
Double Breakout (Beta 1)|Double Breakout Beta 1 by Daniel Bienvenu|Double Breakout Beta 1|Double Breakout Beta 1|
Double Breakout (Beta 2)|Double Breakout Beta 2 by Daniel Bienvenu|Double Breakout Beta 2|Double Breakout Beta 2|
DragonFire|DragonFire|DragonFire|DragonFire|
Dragon's Lair|||Dragon's Lair|
Dr. J and Larry Bird Go One-on-One|Dr. J and Larry Bird Go One on One|Dr. J & Larry Bird Go One on One|Dr. J and Larry Bird Go One on One|
Dr. Seuss's Fix-Up the Mix-Up Puzzler|Dr. Seuss's Fix-Up The Mix-Up Puzzler|Dr. Seuss's Fix-Up The Mix-Up Puzzler|Dr. Seuss's Fix-Up the Mix-Up Puzzler|
ELDCDBPAPP|ELDCDBPAPP|ELDCDBPAPP|ELDCDBPAPP|
Escape from the Mind Master|Escape From The Mind Master|Escape From The Mind Master|Escape from the Mind Master|
Evolution|Evolution|Evolution|Evolution|
Explosion|Explosion by Daniel Bienvenu|Explosion|Explosion|
Facemaker|Facemaker|Facemaker|Facemaker|
Fall Guy|Fall Guy|Fall Guy|Fall Guy|
Fathom|Fathom|Fathom|Fathom|
Final Test Cartridge|Final Test Cartridge|Final Test Cartridge|Final Test Cartridge|
Flipper Slipper|Flipper Slipper|Flipper Slipper|Flipper Slipper|
Fortune Builder|Fortune Builder|Fortune Builder|Fortune Builder|
Fraction Fever|Fraction Fever|Fraction Fever|Fraction Fever|
Frantic|||Frantic|
Frantic Freddy|Frantic Freddy|Frantic Freddy|Frantic Freddy|
Frenzy!|Frenzy!|Frenzy!|Frenzy|
Frogger|Frogger|Frogger|Frogger|
Frogger II: ThreeeDeep!|Frogger II - ThreeDeep!|Frogger II - ThreeDeep!|Frogger II - Threeedeep!|
Frontline|Frontline|Frontline|Frontline|
Galaxian|Galaxian|Galaxian|Galaxian|
GamePack (Demo 1)|GamePack Demo 1 by Daniel Bienvenu|GamePack Demo 1|Game Pack Demo 1|
GamePack (Demo 2)|GamePack Demo 2 by Daniel Bienvenu|GamePack Demo 2|Game Pack Demo 2|
GamePack (VIC-20 Demo)|GamePack VIC-20 Demo by Daniel Bienvenu|GamePack VIC-20 Demo|Game Pack VIC-20 Demo|
Gateway to Apshai|Gateway to Apshai|Gateway to Apshai|Gateway to Apshai|
Get Booty|Get Booty 4k|Get Booty|Get Booty|
Ghost Trap|||Ghost Trap|
Goldorak Pic|Goldorak Pic|Goldorak Pic|Goldorak Pic|
Gorf|Gorf|Gorf|Gorf|
Gulkave|Gulkave|Gulkave|Gulkave|
Gust Buster|Gust Buster|Gust Buster|Gust Buster|
Gyruss|Gyruss|Gyruss|Gyruss|
Happy Halloween|Happy Halloween by Daniel Bienvenu|Happy Halloween|Happy Halloween|
H.E.R.O.|H.E.R.O.|H.E.R.O|H.E.R.O.|
Illusions|Illusions|Illusions|Illusions|
It's Only Rock 'n' Roll|Its Only Rock 'N' Roll|Its Only Rock 'N' Roll|It's Only Rock 'n' Roll|
James Bond 007|James Bond 007|James Bond|James Bond 007|
JBulman Junior|JBulman Junior by Daniel Bienvenu|JBulman Junior|JBulman Junior|
Jeepers Creepers|||Jeepers Creepers|
Jetp4k|Jetpack 4K by Harvey deKleine|Jetpack 4K|Jetpack|
Joust|Joust|Joust|Joust|
Juke Box|Juke Box|Juke Box|Juke Box|
Jumpman Junior|Jumpman Junior|Jumpman Junior|Jumpman Junior|
Jump or Die|Jump or Die by Daniel Bienvenu|Jump or Die|Jump or Die|
Jungle Hunt|Jungle Hunt|Jungle Hunt|Jungle Hunt|
Ken Uston's BlackJack & Poker|Ken Uston's Blackjack-Poker|Ken Uston's Blackjack-Poker|Ken Uston Blackjack-Poker|
Kevtris|Kevtris by Kevin Horton|Kevtris|Kevtris|
Keystone Kapers|Keystone Kapers|Keystone Kapers|Keystone Kapers|
Kill Barney in Tokyo|Kill Barney in Tokyo by Daniel Bienvenu|Kill Barney in Tokyo|Kill Barney in Tokyo|
Killer Instinct|Killer Instinct by Daniel Bienvenu|Killer Instinct|Killer Instinct|
Lady Bug|Lady Bug|Lady Bug|Lady Bug|
Learning with Leeper|Learning With Leeper|Learning With Leeper|Learning with Leeper|
Linking Logic|Linking Logic|Linking Logic|Linking Logic|
Logic Levels|Logic Levels|Logic Levels|Logic Levels|
Looping|Looping|Looping|Looping|
Maoo Patrol|||Maoo Patrol|
M*A*S*H|M.A.S.H.|M.A.S.H|M.A.S.H.|
Matrix Demo|Matrix Demo by Daniel Bienvenu|Matrix Demo|Matrix Demo|
Matt Patrol|Matt Patrol|Matt Patrol|Matt Patrol|
Maze Maniac|Maze Maniac|Maze Maniac|Maze Maniac|
Memory Manor|Memory Manor|Memory Manor|Memory Manor|
Meteoric Shower|Meteoric Shower|Meteoric Shower|Meteoric Shower|
Miner 2049er|Miner 2049er|Miner 2049er|Miner 2049er|
Monkey Academy|Monkey Academy|Monkey Academy|Monkey Academy|
Montezuma's Revenge|Montezuma's Revenge|Montezuma's Revenge|Montezuma's Revenge|
Moon Patrol|Moon Patrol|Moon Patrol|Moon Patrol|
Moonsweeper|Moonsweeper|Moonsweeper|Moonsweeper|
Motocross Racer|Motocross Racer|Motocross Racer|Motocross Racer|
Mountain King|Mountain King|Mountain King|Mountain King|
Mouse Trap|Mousetrap|Mousetrap|Mousetrap|
Mr. Chin|||Mr Chin|
Mr. Do!|Mr. Do!|Mr. Do!|Mr. Do!|
Mr. Do!'s Castle|Mr. Do's Castle|Mr Do's Castle|Mr. Do's Castle|
Ms. Space Fury|Ms. Space Fury|Ms. Space Fury|Ms. Space Fury|
Music: Volume 1|Music Vol 1 by Daniel Bienvenu|Music Vol 1|Music Vol 1|
Name|GoodName|NoIntro|TOSEC|ReDump
New|New by Daniel Bienvenu|New|New|
Nim|Nim by Daniel Bienvenu|Nim|Nim|
Nova Blast|Nova Blast|Nova Blast|Nova Blast|
Number Bumper|Number Bumper|Number Bumper|Number Bumper|
Oil's Well|Oil's Well|Oil's Well|Oil's Well|
Old Skool Demo|Old Skool Demo 01 by Guy Foster|Old Skool Demo 01|Old Skool Demo 01|
Omega Race|Omega Race|Omega Race|Omega Race|
One on One|One on One Basketball|One on One|One on One|
Orbit|Orbit|Orbit|Orbit|
Pac-Man Collection: Demo 1|Pac-Man Collection Demo by Opcode|Pac-Man Collection Demo|Pac-Man Collection|
Pac-Man Collection: Demo 2|Pac-Man Collection Demo 2 by Opcode|Pac-Man Collection Demo 2|Pac-Man Collection - Demo 2|
Pac-Man Collection: Music Demo|Pac-Man Collection Music Demo by Opcode|Pac-Man Collection Music Demo|Pac-Man Collection Music Demo|
Pac-Man|Pac-Man|Pac-Man|Pac-Man|
Pepper II|Pepper II|Pepper II|Pepper II|
Pere Noel|Pere Noel by Daniel Bienvenu|Pere Noel|Pere Noel|
Pitfall II: Lost Caverns|Pitfall II - Lost Caverns|Pitfall II - Lost Caverns|Pitfall II - Lost Caverns|
Pitfall!|Pitfall!|Pitfall!|Pitfall!|
Pitstop|Pitstop|Pitstop|Pitstop|
Popeye|Popeye|Popeye|Popeye|
Porky's|Porky's|Porky's|Porky's|
Power Lords: Quest for Volcan|Power Lords - Quest for Volcan|Power Lords - Quest for Volcan|Power Lords - Quest for Volcan|
Puckman Sounds|Puckman Sounds V001|Puckman Sounds V002|Puckman Sounds v001|
Puckman Sounds (V002)|Puckman Sounds V002||Puckman Sounds v002|
Puckman Sounds (V003)|Puckman Sounds V003||Puckman Sounds v003|
Purple Dinosaur Massacre|Purple Dinosaur Massacre by John Dondzila|Purple Dinosaur Massacre|Purple Dinosaur Massacre|
Q*bert|Q-bert|Q-bert|Q-Bert|
Q*bert's Qubes|Q-bert II|Q-bert II|Q-Bert Qubes|
Quest for Quintana Roo|Quest for Quintana Roo|Quest for Quintana Roo|Quest for Quintana Roo|
Reversi (Demo)|Reversi Demo by Daniel Bienvenu|Reversi Demo|Reversi - Demo|
Reversi|Reversi by Daniel Bienvenu|Reversi|Reversi|
River Raid|River Raid|River Raid|River Raid|
Robin Hood|Robin Hood|Robin Hood|Robin Hood|
Rock n' Bolt|Rock 'N' Bolt|Rock 'N' Bolt|Rock 'n Bolt|
Rocky Super Action Boxing|Rocky Super-Action Boxing|Rocky Super-Action Boxing|Rocky Super Action Boxing|
Roc 'n Rope|Roc 'N Rope|Roc 'N Rope|Roc 'n Rope|
Rolloverture|Rolloverture|Rolloverture|Rolloverture|
Sammy Lightfoot|Sammy Lightfoot|Sammy Lightfoot|Sammy Lightfoot|
Schlange CV Demo|Schlange CV Demo|Schlange CV V0.10 Demo|Schlange CV|
Schlange CV Demo (V0.10)|Schlange CV V0.10 Demo|||
Scroll Demo 2|||Scroll Demo 2|
Scroll Demo|Scroll Demo by Daniel Bienvenu|Scroll Demo|Scroll Demo|
Search for the Stolen Crown Jewels 1 (Demo)|Search for the Stolen Crown Jewels Demo V1.0|||
Search for the Stolen Crown Jewels 2 (Demo)|Search for the Stolen Crown Jewels 2 Demo|Search for the Stolen Crown Jewels 2 Demo|Search for the Stolen Crown Jewels 2 (demo) (2007)(Krause, Philipp Klaus)(PD)|
Search for the Stolen Crown Jewels 3|||Search for the Stolen Crown Jewels 3|
Search for the Stolen Crown Jewels (Demo)|Search for the Stolen Crown Jewels Demo|Search for the Stolen Crown Jewels Demo V1.0|Search for the Stolen Crown Jewels Demo|
Search for the Stolen Crown Jewels|Search for the Stolen Crown Jewels|Search for the Stolen Crown Jewels|Search for the Stolen Crown Jewels|
Sector Alpha|Sector Alpha|Sector Alpha|Sector Alpha|
Sewer Sam|Sewer Sam|Sewer Sam|Sewer Sam|
Shunting Puzzle|||Shunting Puzzle|
Simple Screen Show|Simple Screen Show by Daniel Bienvenu|Simple Screen Show|Simple Screen Show|
Sir Lancelot|Sir Lancelot|Sir Lancelot|Sir Lancelot|
Skiing|Skiing|Skiing|Skiing|
Sky Jaguar|Sky Jaguar|Sky Jaguar|Sky Jaguar|
Slither|Slither|Slither|Slither|
Slurpy|Slurpy|Slurpy|Slurpy|
Smash (4kb)|Smash 4kb by Daniel Bienvenu|Smash (4kb)|Smash (2004)(Bienvenu, Daniel)(PD)[4k]|
Smash (8kb)|Smash 8kb by Daniel Bienvenu|Smash (8kb)|Smash (2004)(Bienvenu, Daniel)(PD)[8k]|
Smooth Criminal Demo|||Smooth Criminal Demo|
Smurf: Paint 'n' Play Workshop|Smurf - Paint 'n Play Workshop|Smurf Paint 'n Play Workshop|Smurf Paint 'n Play Workshop|
Smurf: Rescue in Gargamel's Castle|Smurf - Rescue in Gargamel's Castle|Smurf Rescue|Smurf Rescue in Gargamel's Castle|
Sound FX: Volume 1|Sound FX Vol 1 by Daniel Bienvenu|Sound FX Vol 1|Sound FX Vol 1|
Sound FX: Volume 2|Sound FX Vol 2 by Daniel Bienvenu|Sound FX Vol 2|Sound FX Vol 2|
Space Caverns|Space Caverns|Space Caverns|Space Caverns|
Space Fury|Space Fury|Space Fury|Space Fury|
Space Hunter|Space Hunter|Space Hunter|Space Hunter|
Space Invaders Collection (Demo)|Space Invaders Collection Demo|Space Invaders Collection Pack Demo|Space Invaders Collection Demo|
Space Invasion (Demo)|Space Invasion Demo by John Dondzila|Space Invasion - Demo|Space Invasion Demo|
Space Invasion|Space Invasion by John Dondzila|Space Invasion|Space Invasion|
Space Panic|Space Panic|Space Panic|Space Panic|
Space Trainer|Space Trainer|Space Trainer|Space Trainer|
Spaz Attak: No Suttering|||Spaz Attak - No Suttering|
Spaz Attak|||Spaz Attak|
Spaz Attak (Teaser)|Spaz Attak Teaser|Spaz Attak|Spaz Attak Teaser|
Spaz Attak: with Death Eggs|||Spaz Attak - with Death Eggs|
Spaz Attak: With Levels|||Spaz Attak - With Levels|
Spectank (Demo)|Spectank Demo by Daniel Bienvenu|Spectank Demo|Spectank Demo|
Spectron|Spectron|Spectron|Spectron|
Spy Hunter|Spy Hunter|Spy Hunter|Spy Hunter|
Squares! 4K (Final)|Squares! 4K (Final) by Harvey deKleine||Squares (2001-04-15)(deKleine, Harvey)(PD)|
Squares! 4K|Squares! 4K by Harvey deKleine|Squares! 4K|Squares! 4K (2006)(deKleine, Harvey)(PD)|
Squares! 4K (V 01)|Squares! 4K (v01) by Harvey deKleine||Squares! 4K v01 (2006)(deKleine, Harvey)(PD)|
Squares! 4K (V 02)|Squares! 4K (v02) by Harvey deKleine||Squares! 4K v02 (2006)(deKleine, Harvey)(PD)|
Squish'em Sam!|Squish 'Em Sam!|Squish 'Em Sam!|Squish'em Featuring Sam!|
Star Demo|Star Demo|Star Demo|Star Demo|
Star Fortress|Star Fortress by John Dondzila|Star Fortress|Star Fortress|
Starry Nights 3 (Demo)|Starry Nights 3 Demo by Guy Foster|Starry Nights 3 Demo|Starry Nights 3 (demo) (2004)(Foster, Guy)(PD)|
Starry Nights (Demo)|Starry Nights Demo by Guy Foster|Starry Nights Demo|Starry Nights (demo) (2005-05-05)(Foster, Guy)(PD)|
Star Trek Strategic Operations Simulator|Star Trek - Strategic Operations Simulator|Star Trek|Star Trek - Strategic Operations Simulator|
Star Wars Arcade|Star Wars - The Arcade Game|Star Wars|Star Wars - The Arcade Game|
Steamroller|Steamroller|Steamroller|Steamroller|
Strike It!|Strike It!|Strike It!|Strike It!|
Stubby (Demo)|Stubby Demo by Yannick Proulx|Stubby Demo|Stubby|
St. Valentine's Day (No Alien Head)|||St. Valentine's Day No Alien Head|
St. Valentine's Day|St. Valentine's Day|St. Valentines Day|St. Valentine's Day|
Subroc|Subroc|Subroc|Subroc|
Super Action Baseball|Super Action Baseball|Super Action Baseball|Super Action Baseball|
Super Action Controller Test Cartridge|Super Action Controller Test Cartridge|Super Controller Tester|Super Controller Tester|
Super Action Football|Super Action Football|Super Action Football|Super Action Football|
Super Action Soccer|Super Action Soccer|Super Action Soccer|Super Action Soccer|
Super Cobra|Super Cobra|Super Cobra|Super Cobra|
Super Cross Force|Super Cross Force|Super Cross Force|Super Cross Force|
Super DK! Junior|Super DK! Junior|Super DK! Junior|Super DK! Junior|
Super DK|Super DK!|Super DK!|Super DK!|
Super Pong (Demo)|Superpong Demo|Superpong - Demo|Superpong Demo|
Super Sketch|Super Sketch by Steve Roubik|Super Sketch|Super Sketch|
Tank Wars|Tank Wars|Tank Wars|Tank Wars|
Tapper|Tapper|Tapper|Tapper|
Tarzan: From Out Of The Jungle...|Tarzan|From Out Of The Jungle - Tarzan|Tarzan|
Telly Turtle|Telly Turtle|Telly Turtle|Telly Turtle|
Tenchi Muyo (Demo)|Tenchi Muyo Demo by Daniel Bienvenu|Tenchi Muyo - Demo|Tenchi Muyo Demo|
Terra Attack|||Terra Attack|
The Dukes of Hazzard|Dukes of Hazzard, The|Dukes of Hazzard, The|Dukes of Hazzard, The|
The Heist|Heist, The|Heist, The|Heist, The|
The Yolk's on You|Yolk's on You, The|Yolk's on You, The|Yolks on You, The|
Threshold|Threshold|Threshold|Threshold|
Tic Tac Toe|Tic Tac Toe by Norman Nithman|Tic Tac Toe|Tic Tac Toe|
Time Pilot|Time Pilot|Time Pilot|Time Pilot|
Tomarc the Barbarian|Tomarc the Barbarian|Tomarc the Barbarian|Tomarc the Barbarian|
Tournament Tennis|Tournament Tennis|Tournament Tennis|Tournament Tennis|
Tunnels & Trolls: Demo|Tunnels & Trolls Demo|Tunnels & Trolls|Tunnels & Trolls|
Turbo|Turbo|Turbo|Turbo|
Tutankham|Tutankham|Tutankham|Tutankham|
Up'n Down|Up 'N Down|Up 'N Down|Up 'n Down|
Vampire (Venture Hack)|Vampire|Vampire|Vampire|
Venture|Venture|Venture|Venture|
Victory|Victory|Victory|Victory|
Video Hustler|Video Hustler|Video Hustler|Video Hustler|
Vision 8|Vision 8 V1.0 by Marcel de Kogel|Vision 8 V1.0|Vision 8|
War Games|War Games|War Games|War Games|
War Room|War Room|War Room|War Room|
Wing War|Wing War|Wing War|Wing War|
Winky Trap|Winky Trap by John Dondzila|Winky Trap|Winky Trap|
Witch|Witch|Witch|Witch|
Wizard of Id's Wizmath|Wizard of Id's Wizmath|Wizard of Id's Wizmath|Wizard of Id's Wizmath|
Word Feud|Word Feud|Word Feud|Word Feud|
Xonox Double Ender: Artillery Duel and Chuck Norris Superkicks|Xonox Double Ender - Artillery Duel and Chuck Norris Superkicks|Xonox Double Ender - Artillery Duel & Chuck Norris Superkicks|Xonox Double Ender - Artillery Duel and Chuck Norris Superkicks|
Zaxxon|Zaxxon|Zaxxon|Zaxxon|
Zenji|Zenji|Zenji|Zenji|
