2 Pak Special: Alien Force & Hoppy|2 Pak Special  - Hoppy, Alien Force||2 Pak Special Light Green - Hoppy & Alien Force|
2 Pak Special: Cavern Blaster & City War|2 Pak Special  - Cavern Blaster, City War||2 Pak Special Magenta - Cavern Blaster & City War|
2 Pak Special: Space Voyage & Fire Alert|2 Pak Special  - Space Voyage, Fire Alert||2 Pak Special Orange - Space Voyage & Fire Alert|
32 in 1 Game Cartridge|||32-in-1 Game Cartridge|
3-D Tic-Tac-Toe|3-D Tic-Tac-Toe||3-D Tic-Tac-Toe|
Acid Drop|Acid Drop||Acid Drop|
Action Force|Action Force||Action Force|
Adventure|Adventure||Adventure|
Adventure Plus|Adventure Plus||Adventure Plus|
Adventures of TRON|Adventures of Tron||Adventures of Tron|
Adventures on GX-12|Adventures on GX-12||Adventures on GX-12|
Airlock|Airlock||Airlock|
Air Raid|Air Raid||Air Raid|
Air Raiders|Air Raiders||Air Raiders|
Air-Sea Battle|Air-Sea Battle||Air-Sea Battle|
Alien|Alien||Alien|
Alligator People|Alligator People||Alligator People|
Alpha Beam with Ernie|Alpha Beam with Ernie|||
Amidar|Amidar||Amidar|
Aquaventure|Aquaventure||Aquaventure|
Armor Ambush|Armor Ambush||Armor Ambush|
Artillery Duel|Artillery Duel||Artillery Duel|
Assault|Assault||Assault|
AStar|AStar|||
Asterix|Asterix||Asterix|
Asteroids|Asteroids||Asteroids|
Asteroids DC+|Asteroids DC+ by Thomas Jentzsch||Asteroids DC+|
Astro Attack|Astro Attack||Astro Attack|
Astroblast|Astroblast||Astroblast|
Atari Video Cube|Atari Video Cube||Atari Video Cube|
Atlantis|Atlantis||Atlantis|
Atlantis II|Atlantis II||Atlantis II|
AVCStec Challenge|AVCSTec Challenge|||
Bachelorette Party|Bachelorette Party||Bachelorette Party|
Bachelor Party|Bachelor Party||Bachelor Party|
Backfire|Backfire Prototype||Backfire|
Backgammon|Backgammon|Backgammon|Backgammon|
Bank Heist|Bank Heist|Bank Heist|Bank Heist|
Barnstorming|Barnstorming|Barnstorming|Barnstorming|
Basic Math|Basic Math|||
Basketball|Basketball||Basketball|
Battle Zone|Battlezone||Battlezone|
Beamrider|Beamrider||Beamrider|
Beany Bopper|Beany Bopper|Beany Bopper|Beany Bopper|
Berenstain Bears|Berenstain Bears|Berenstain Bears|Berenstain Bears|
Bermuda Triangle|Bermuda Triangle||Bermuda Triangle|
Berzerk|Berzerk|Berzerk|Berzerk|
Big Bird's Egg Catch|Big Bird's Egg Catch|Big Bird's Egg Catch||
Blackjack|Blackjack|Blackjack|Blackjack|
Blue Print|Blue Rod Demo|Blueprint|Blueprint|
BMX Air Master|BMX Air Master|BMX Air Master|BMX Air Master|
Boing!|Boing!|Boing!|Boing!|
Boulder Dash|Boulder Dash|||
Bowling|Bowling||Bowling|
Boxing|Boxing||Boxing|
Breakout|Breakout|Breakout ~ Breakaway IV|Breakout - Breakaway IV|
Bridge|Bridge||Bridge|
Buck Rogers: Planet of Zoom|Buck Rogers - Planet of Zoom|Buck Rogers - Planet of Zoom|Buck Rogers - Planet of Zoom|
Bugs Bunny|Bugs Bunny||Bugs Bunny|
Bump 'n' Jump|Bump 'N' Jump||Bump 'N' Jump|
California Games|California Games||California Games|
Checkers|Checkers||Checkers|
Chopper Command|Chopper Command||Chopper Command|
Combat|Combat||Combat|
Combat Redux|Combat Redux Black by neotokeo2001||Combat Redux|
Combat Rock|Combat Rock||Combat Rock|
Communist Mutants from Space|Communist Mutants From Space||Communist Mutants From Space|
Congo Bongo|Congo Bongo||Congo Bongo|
Cookie Monster Munch|Cookie Monster Munch|||
Cosmic Commuter|Cosmic Commuter||Cosmic Commuter|
Cosmic Creeps|Cosmic Creeps||Cosmic Creeps|
Crack'ed|Crack'ed||Crack'ed|
Crackpots|Crackpots||Crackpots|
Crazy Climber|Crazy Climber||Crazy Climber|
Crystal Castles|Crystal Castles||Crystal Castles|
Custer's Revenge|Custer's Revenge||Custer's Revenge|
Dark Chambers|Dark Chambers||Dark Chambers|
Dark Mage|Dark Mage||Dark Mage|
Decathlon|Decathlon||Decathlon|
Defender|Defender||Defender|
Demon Attack|Demon Attack||Demon Attack|
Fast Eddie|Fast Eddie||Fast Eddie|
Fire Fighter|Fire Fighter||Fire Fighter|
Fire Fly|Fire Fly||Fire Fly|
Forest|Forest||Forest|
Ghostbusters|Ghostbusters||Ghostbusters|
G.I. Joe: Cobra Strike|G.I. Joe - Cobra Strike||G.I. Joe - Cobra Strike|
Glacier Patrol|Glacier Patrol||Glacier Patrol|
Gopher|Gopher||Gopher|
Hunchy 2|Hunchy|||
Klax|Klax|||
Lady Bug|Lady Bug|||
Midnight Magic|Midnight Magic||ZZZ-UNK-Midnight Magic|
Miner 2049er: Volume II|Miner 2049er Volume II||Miner 2049er Volume II|
Missile Command|Missile Command||Missile Command|
Mountain King|Mountain King|||
Name|GoodName|NoIntro|TOSEC|ReDump
Obelix|Obelix|||
Pepsi Invaders|Pepsi Invaders - Coke Wins||Pepsi Invaders|
Popeye|Popeye|||
RealSports Baseball|RealSports Baseball|||
Revenge of the Apes|Revenge of the Apes|||
Riddle of the Sphinx|Riddle of the Sphinx|||
Sea Hawk|Sea Hawk|||
Sir Lancelot|Sir Lancelot|||
Sorcerer's Apprentice|Sorcerer's Apprentice||ZZZ-UNK-Sorcerer's Apprentice|
Starmaster|Starmaster|||
Star Raiders|Star Raiders|||
Star Wars: Return of the Jedi - Death Star Battle|Star Wars - Return of the Jedi - Death Star Battle|||
Taz|Taz|||
Time Warp|Time Warp|||
Towering Inferno|Towering Inferno|||
TRON: Deadly Discs|TRON - Deadly Discs|||
Winter Games|Winter Games|||
