007 Shitou: The Duel|007 Shitou|007 Shitou - The Duel||
16t|16 Ton|16t|16t|
2020 Toshi Super Baseball||2020 Toshi Super Baseball||
3 Ninjas Kick Back|3 Ninjas Kick Back|3 Ninjas Kick Back|3 Ninjas Kick Back|
688 Attack Sub|688 Attack Sub|688 Attack Sub|688 Attack Sub|
6-PAK||6-Pak||
Aa Harimanada|Aah! Harimanada|Aa Harimanada|Aa Harimanada|
Action 52|Action 52|Action 52|Action 52|
Addams Family Values|Addams Family Values|Addams Family Values|Addams Family Values|
A Dinosaur's Tale||Dinosaur's Tale, A|Dinosaur's Tale, A|
Advanced Busterhawk Gleylancer|Gley Lancer|Advanced Busterhawk Gleylancer||
Advanced Daisenryaku: Doitsu Dengeki Sakusen|Advanced Daisenryaku|Advanced Daisenryaku - Deutsch Dengeki Sakusen|Advanced Daisenryaku - Deutsch Dengeki Sakusen Rev 1|
Adventurous Boy: Mao Xian Xiao Zi||Adventurous Boy - Mao Xian Xiao Zi||
Aerobiz|Aerobiz|Aerobiz|Aerobiz|
Aerobiz Supersonic|Aerobiz Supersonic|Aerobiz Supersonic|Aerobiz Supersonic|
Aero Blasters: Trouble Specialty Raid Unit|Aero Blasters|Aero Blasters|Aero Blasters|
Aero the Acro-Bat 2|Aero the Acro-Bat 2|Aero the Acro-Bat 2|Aero the Acrobat 2|
Aero the Acro-Bat|Aero the Acro-Bat|Aero the Acro-Bat|Aero the Acro-Bat|
After Burner II|After Burner II|After Burner II|After Burner II|
Air Buster|Air Buster|Air Buster|Air Buster|
Air Diver|Air Diver|Air Diver|Air Diver|
Air Management II: Kouku Ou wo Mezase|Air Management II - Kouku Ou wo Mezase|Air Management II - Koukuuou o Mezase||
Air Management: Oozora ni Kakeru|Air Management - Oozora ni Kakeru|Air Management - Oozora ni Kakeru||
Aladdin II|Aladdin II|||
Alex Kidd: Cheongong Maseong|Alex Kidd - Cheongongmaseong|Alex Kidd - Cheongong Maseong||
Alex Kidd in the Enchanted Castle|Alex Kidd in the Enchanted Castle|Alex Kidd in the Enchanted Castle|Alex Kidd in the Enchanted Castle|
Alex Kidd: Tenkuu Majou||Alex Kidd - Tenkuu Majou||
Alien³|Alien 3|Alien 3|Alien 3|
Alien Soldier|Alien Soldier|Alien Soldier|Alien Soldier|
Alien Storm|Alien Storm|Alien Storm|Alien Storm|
Alisia Dragoon|Alisia Dragoon|Alisia Dragoon|Alisia Dragoon|
Altered Beast|Altered Beast|Altered Beast|Altered Beast Rev 2|
American Gladiators|American Gladiators|American Gladiators|American Gladiators|
Andre Agassi Tennis|Andre Agassi Tennis|Andre Agassi Tennis|Andre Agassi Tennis|
Animaniacs|Animaniacs|Animaniacs|Animaniacs|
Another World|Another World|Another World|Another World|
Aoki Ookami to Shiroki Meshika: Genchõ Hishi|Aoki Ookami to Shiroki Meshika - Genchou Hishi|Aoki Ookami to Shiroki Meshika - Genchou Hishi|Aoki Ookami to Shiroki Meshika - Genchou Hishi|
Aq Renkan Awa|Aq Renkan Awa|Aq Renkan Awa||
Arcade Classics|Arcade Classics|Arcade Classics|Arcade Classics|
Arch Rivals: The Arcade Game|Arch Rivals|Arch Rivals - The Arcade Game|Arch Rivals|
Arcus Odyssey|Arcus Odyssey|Arcus Odyssey|Arcus Odyssey|
A Ressha de Ikou MD|A Ressha de Gyoukou MD|A Ressha de Ikou MD|A Ressha de Gyoukou MD|
Arnold Palmer Tournament Golf|Arnold Palmer Tournament Golf|Arnold Palmer Tournament Golf||
Arrow Flash|Arrow Flash|Arrow Flash|Arrow Flash|
Art Alive!|Art Alive!|Art Alive||
Art of Fighting|Art of Fighting|Art of Fighting|Art of Fighting|
Assault Suit Leynos|Assault Suits Leynos|Assault Suit Leynos|Assault Suits Leynos|
Astérix and the Great Rescue|Asterix and the Great Rescue|Asterix and the Great Rescue|Asterix and the Great Rescue|
Asterix and the Power of the Gods|Asterix and the Power of The Gods|Asterix and the Power of the Gods|Asterix and the Power of the Gods|
Atomic Robo-Kid|Atomic Robo-Kid|Atomic Robo-Kid|Atomic Robo-Kid|
Atomic Runner|Atomic Runner|Atomic Runner|Atomic Runner|
ATP Tour Championship Tennis|ATP Tour Championship Tennis|ATP Tour|ATP Tour Championship Tennis|
Australian Rugby League|Australian Rugby League|Australian Rugby League||
Awesome Possum Kicks Dr. Machino's Butt|Awesome Possum Kicks Dr. Machino's Butt!|Awesome Possum Kicks Dr Machino's Butt!|Awesome Possum... Kicks Dr. Machino's Butt!|
Awogue||Aworg||
AWS Pro Moves Soccer|AWS Pro Moves Soccer|AWS Pro Moves Soccer||
Ayrton Senna's Super Monaco GP II|Ayrton Senna's Super Monaco GP II|Ayrton Senna's Super Monaco GP II||
Baby's Day Out|Baby's Day Out|Baby's Day Out||
Back to the Future Part III|Back to the Future Part III|Back to the Future Part III||
Bad Omen|Bad Omen|Bad Omen||
Bahamut Senki|Bahamut Senki|Bahamut Senki||
Ball Jacks|Ball Jacks|Ball Jacks|Ball Jacks|
Ballz 3D: Fighting at its Ballziest|Ballz|Ballz 3D - Fighting at Its Ballziest ~ Ballz 3D - The Battle of the Ballz|Ballz|
Barbie Super Model|Barbie Super Model|Barbie Super Model||
Barbie Vacation Adventure|Barbie Vacation Adventure|Barbie Vacation Adventure||
Bare Knuckle II|Bare Knuckle II|Bare Knuckle II||
Bare Knuckle III|Bare Knuckle III|Bare Knuckle III||
Bare Knuckle II: Shitou heno Chingonka||Bare Knuckle II - Shitou heno Chingonka ~ Streets of Rage II||
Bare Knuckle: Ikari no Tetsuken||Bare Knuckle - Ikari no Tetsuken ~ Streets of Rage||
Barkley: Shut Up and Jam! 2|Barkley Shut Up and Jam! 2|Barkley Shut Up and Jam 2||
Barkley: Shut Up and Jam!|Barkley Shut Up and Jam!|Barkley Shut Up and Jam!||
Barney's Hide & Seek Game|Barney's Hide & Seek Game|Barney's Hide & Seek Game|Barney's Hide & Seek Game|
Barver Battle Saga: Tai Kong Zhan Shi||Barver Battle Saga - Tai Kong Zhan Shi||
Barver Battle Saga: The Space Fighter|Barver Battle Saga - The Space Fighter|||
BASS Masters Classic|Bass Masters Classics|Bass Masters Classic||
BASS Masters Classic: Pro Edition|Bass Masters Classic Pro Edition|Bass Masters Classic - Pro Edition||
Batman Forever|Batman Forever|Batman Forever|Batman Forever|
Batman: Return of the Joker|||Batman - Return of the Joker|
Batman Returns|Batman Returns|Batman Returns|Batman Returns|
Batman: Revenge of the Joker|Batman - Revenge of the Joker|Batman - Revenge of the Joker||
Batman: The Video Game|Batman|Batman||
Battle Frenzy|||Battle Frenzy|
Battle Golfer Yui|Battle Golfer Yui|Battle Golfer Yui||
Battle Mania|Battle Mania|Battle Mania||
Battle Mania Daiginjō|Battle Mania - Dai Gin Jou|Battle Mania Daiginjou||
Battlemaster|Battlemaster|Battlemaster||
Battle Squadron|Battle Squadron|Battle Squadron||
BattleTech: A Game of Armored Combat|Battletech|BattleTech - A Game of Armored Combat|Battletech|
Battletoads|Battletoads|Battletoads||
Battletoads & Double Dragon: The Ultimate Team|Battletoads and Double Dragon|Battletoads and Double Dragon||
Beast Warriors|Beast Warriors|Beast Warriors||
Beast Wrestler|Beast Wrestler|Beast Wrestler||
Beavis and Butt-head|Beavis and Butt-head|Beavis and Butt-Head||
Beggar Prince|||Beggar Prince|
Best of the Best Championship Karate|Best of the Best - Championship Karate|||
Beyond Oasis|Beyond Oasis|Beyond Oasis|Beyond Oasis|
Bible Adventures|Bible Adventures|Bible Adventures||
Bill Walsh College Football '95|Bill Walsh College Football '95|Bill Walsh College Football 95||
Bill Walsh College Football|Bill Walsh College Football|Bill Walsh College Football||
Bimini Run|Bimini Run|Bimini Run||
Bio-hazard Battle|Bio-Hazard Battle|Bio Hazard Battle||
Bishōjo Senshi Sailor Moon|Bishoujo Senshi Sailor Moon|Bishoujo Senshi Sailor Moon||
Blades of Vengeance|Blades of Vengeance|Blades of Vengeance||
Blaster Master 2|Blaster Master 2|Blaster Master 2||
Blockbuster World Video Game Championship II|Blockbuster World Video Game Championship II|Blockbuster World Video Game Championship II||
Blockout|Block Out|Blockout||
Bloodshot|Blood Shot|Bloodshot||
Blue Almanac|Blue Almanac|Blue Almanac||
B.O.B.|B.O.B|B.O.B.||
Body Count|Body Count|Body Count||
Bonanza Bros.|Bonanza Bros.|Bonanza Bros.||
Bonkers|Bonkers|Bonkers||
Boogerman: A Pick and Flick Adventure||Boogerman - A Pick and Flick Adventure|Boogerman - A Pick and Flick Adventure|
Boogie Woogie Bowling|Boogie Woogie Bowling|Boogie Woogie Bowling||
Boxing Legends of the Ring|Boxing Legends of the Ring|Boxing Legends of the Ring||
Bram Stoker's Dracula|Bram Stoker's Dracula|Bram Stoker's Dracula||
Brett Hull Hockey 95|Brett Hull Hockey '95|Brett Hull Hockey '95||
Brian Lara Cricket 96|Brian Lara Cricket 96|Brian Lara Cricket 96||
Brian Lara Cricket|Brian Lara Cricket|Brian Lara Cricket||
Brutal: Paws of Fury|Brutal - Paws of Fury|Brutal - Paws of Fury||
Bubba'n'Stix: A Strategy Adventure||Bubba'n'Stix - A Strategy Adventure||
Bubba 'n' Stix|Bubba N Stix|Bubba'n'Stix||
Bubble and Squeak|Bubble and Squeak|Bubble and Squeak||
Bubsy II|Bubsy II|Bubsy II||
Bubsy in: Claws Encounters of the Furred Kind|Bubsy in Claws Encounters of the Furred Kind|Bubsy in Claws Encounters of the Furred Kind||
Buck Rogers: Countdown to Doomsday|Buck Rogers - Countdown to Doomsday|Buck Rogers - Countdown to Doomsday||
Budokan: The Martial Spirit|Budokan - The Martial Spirit|Budokan - The Martial Spirit||
Bugs Bunny in Double Trouble|Bugs Bunny in Double Trouble|Bugs Bunny in Double Trouble||
Bulls Vs. Blazers and the NBA Playoffs|Bulls vs Blazers and the NBA Playoffs|Bulls versus Blazers and the NBA Playoffs||
Bulls Vs. Lakers and the NBA Playoffs|Bulls vs Lakers and the NBA Playoffs|Bulls vs Lakers and the NBA Playoffs||
Burning Force|Burning Force|Burning Force||
Cadash|Cadash|Cadash||
Caesar no Yabou||Caesar no Yabou||
Caesar no Yabou II||Caesar no Yabou II||
Caliber 50|Caliber Fifty|Caliber.50||
California Games|California Games|California Games||
Cal Ripken Jr. Baseball|Cal Ripken Jr. Baseball|Cal Ripken Jr. Baseball||
Cannon Fodder|Cannon Fodder|Cannon Fodder||
Captain America and The Avengers|Captain America and the Avengers|Captain America and the Avengers||
Captain Lang||Captain Lang||
Captain Planet and the Planeteers   |Captain Planet and the Planeteers|Captain Planet and the Planeteers||
Capt'n Havoc|Capt'n Havoc|||
Castle of Illusion: Fushigi no Oshiro Dai Bouken||Castle of Illusion - Fushigi no Oshiro Daibouken||
Castle of Illusion starring Mickey Mouse|Castle of Illusion Starring Mickey Mouse|Castle of Illusion Starring Mickey Mouse||
Castlevania: Bloodlines|Castlevania - Bloodlines|Castlevania - Bloodlines||
Castlevania: The New Generation|Castlevania - The New Generation|Castlevania - The New Generation||
Centurion: Defender of Rome|Centurion - Defender of Rome|Centurion - Defender of Rome||
Chakan|Chakan - The Forever Man|Chakan||
Chameleon Kid|Chameleon Kid|Chameleon Kid|Chameleon Kid|
Championship Bowling|Championship Bowling|Championship Bowling||
Championship Pool|Championship Pool|Championship Pool||
Championship Pro-Am|Championship Pro-Am|Championship Pro-Am||
Champions World Class Soccer|Champions World Class Soccer|Champions World Class Soccer||
Chaoji Dafuweng|Chaoji Dafuweng|||
Chao Ji Da Fu Weng||Chao Ji Da Fu Weng||
Chase H.Q. II|Chase HQ II|Chase H.Q. II||
Chavez II|Chavez II|Chavez II||
Cheese Cat-Astrophe Starring Speedy Gonzales|Cheese Cat-Astrophe Starring Speedy Gonzales|Cheese Cat-Astrophe Starring Speedy Gonzales||
Chelnov: Atomic Runner|Chelnov|Chelnov||
Chess|Chess|||
Chester Cheetah: Too Cool to Fool|Chester Cheetah|Chester Cheetah - Too Cool to Fool||
Chester Cheetah: Wild Wild Quest|Chester Cheetah 2 - Wild Wild Quest|Chester Cheetah - Wild Wild Quest||
Chibi Maruko-Chan: Waku Waku Shopping|Chibi Maruko-Chan - Wakuwaku Shopping|Chibi Maruko-chan - Wakuwaku Shopping||
Chi Chi's Pro Challenge Golf|Chi Chi's Pro Challenge|Chi Chi's Pro Challenge Golf||
Chiki Chiki Boys|Chiki Chiki Boys|Chiki Chiki Boys||
Chinese Chess|Chinese Chess|||
Chōkyūkai Miracle Nine|Chou Yakyuu Miracle Nine|Chou Kyuukai Miracle Nine||
Chō Touryuu Retsuden Dino Land||Chou Touryuu Retsuden Dino Land||
Chuck II: Son of Chuck|Chuck II - Son of Chuck|||
Chuck Rock|Chuck Rock|Chuck Rock||
Chuck Rock II: Son of Chuck|Chuck II - Son of Chuck|Chuck Rock II - Son of Chuck||
Chuck's Excellent Art Tool Animator|Chuck's Excellent Art Tool Animator|||
Clay Fighter|Clay Fighter|Clay Fighter||
Cliffhanger|Cliffhanger|Cliffhanger||
Clue|Clue|Clue||
Coach K College Basketball|Coach K College Basketball|Coach K College Basketball||
Codemasters 2 in 1: Fantastic Dizzy & Cosmic Spacehead|||Codemasters 2 in 1 - Fantastic Dizzy + Cosmic Spacehead|
College Football's National Championship|College Football's National Championship|College Football's National Championship||
College Football's National Championship II|College Football's National Championship II|College Football's National Championship II||
College Football USA '96|College Football USA 96|College Football USA 96||
College Football USA '97: The Road to New Orleans|College Football USA 97 - The Road to New Orleans|College Football USA 97||
College Slam|College Slam|College Slam||
Columns|Columns|Columns||
Columns III: Revenge of Columns|Columns III - Revenge of Columns|Columns III - Revenge of Columns||
Columns III: Taiketsu! Columns World|Columns III - Taiketsu! Columns World|Columns III - Taiketsu! Columns World||
Combat Aces|Combat Aces|||
Combat Cars|Combat Cars|Combat Cars||
Comix Zone|Comix Zone|Comix Zone|Comix Zone|
Command & Conquer|Command & Conquer|||
Commandos|Commandos|||
Congo: The Game|Congo - The Game|Congo||
Conquering the World III|Conquering the World III|||
Contra: Hard Corps|Contra - Hard Corps|Contra - Hard Corps|Contra - Hard Corps|
Cool Spot|Cool Spot|Cool Spot||
Corporation|Corporation|Corporation||
Cosmic Spacehead|Cosmic Spacehead|Cosmic Spacehead||
Crack Down|Crack Down|Crack Down||
Crayon Shin-chan: Arashi o Yobu Enji|Crayon Shin-Chan - Arashi o Yobu Sono Ko|Crayon Shin-chan - Arashi o Yobu Enji||
CrossFire|CrossFire|Cross Fire|Gemfire|
Crude Buster|Crude Buster|Crude Buster||
Crüe Ball|Crue Ball|Crue Ball|Crue Ball|
Crusader of Centy|Crusader of Centy|Crusader of Centy|Crusader of Centy|
Crying: Aseimei Sensou|Crying - Asia Seimei Sensou|Crying - Aseimei Sensou||
Crystal's Pony Tale|Crystal's Pony Tale|Crystal's Pony Tale|Crystal's Pony Tale|
Curse|Curse|Curse||
Cutie Suzuki no Ringside Angel|Cuty Suzuki no Ringside Angel|Cutie Suzuki no Ringside Angel|Cuty Suzuki no Ringside Angel|
Cutthroat Island|Cutthroat Island|CutThroat Island|Cutthroat Island|
Cyberball|CyberBall|CyberBall|Cyberball|
Cyber-Cop|Cyber-Cop|Cyber-Cop|Cyber-Cop|
Cyber Police ESWAT||Cyber Police ESWAT||
Cyborg Justice|Cyborg Justice|Cyborg Justice|Cyborg Justice|
Daffy Duck in Hollywood|Daffy Duck in Hollywood|Daffy Duck in Hollywood||
Dahna||Dahna||
Dahna: Megami Tanjō|Dahna - Megami Tanjou|Dahna Megami Tanjou|Dahna - Megami Tanjou|
Dai Konsen|Dai Konsen|||
Daikoukai Jidai|Daikoukai Jidai|Daikoukai Jidai||
Daikoukai Jidai II|Daikoukai Jidai II|Daikoukai Jidai II||
Daimakaimura|Dai Makaimura|Dai Makaimura|Dai Makaimura|
Dangerous Seed|Dangerous Seed|Dangerous Seed||
Darius II|Darius II|Darius II||
Dark Castle|Dark Castle|Dark Castle||
Darwin 4081|Darwin 4081|Darwin 4081||
Dashin' Desperadoes|Dashin' Desperadoes|Dashin' Desperadoes||
David Crane's Amazing Tennis|David Crane's Amazing Tennis|David Crane's Amazing Tennis||
David Robinson Basketball|David Robinson Basketball|David Robinson Basketball||
David Robinson's Supreme Court|David Robinson's Supreme Court|David Robinson's Supreme Court||
Davis Cup World Tour 2|Davis Cup World Tour Tennis 2|Davis Cup II||
Davis Cup World Tour|Davis Cup World Tour Tennis|Davis Cup Tennis ~ Davis Cup World Tour||
Daze Before Christmas|Daze Before Christmas, The|Daze Before Christmas|Daze Before Christmas|
Deadly Moves|Deadly Moves|Deadly Moves|Deadly Moves|
Death Duel|Death Duel|Death Duel||
DEcapAttack|Decap Attack|DEcapAttack||
Deer Hunter|Deer Hunter|||
Demolition Man|Demolition Man|Demolition Man||
Desert Demolition Starring Road Runner and  Wile E. Coyote|Desert Demolition|Desert Demolition Starring Road Runner and Wile E. Coyote||
Desert Strike: Return to the Gulf|Desert Strike - Return to the Gulf|Desert Strike - Return To The Gulf||
Desert Strike: Wangan Sakusen||Desert Strike - Wangan Sakusen ~ Desert Strike||
Devil Crash MD|Devil Crash MD|Devil Crash MD||
Devilish Mahjong Tower|Devilish Mahjong Tower|||
Devilish: The Next Possession|Devilish - The Next Possession|Devilish - The Next Possession||
Devil's Course 3-D Golf|Devil's Course 3-D Golf|||
Devil's Crush|Devil Crash MD|Devil Crash MD||
Dial Q o Mawase!|Dial Q o Mawase!|Dial Q o Mawase!||
Dick Tracy|Dick Tracy|Dick Tracy||
Dick Vitale's "Awesome, Baby!" College Hoops|Dick Vitale's Awesome Baby! College Hoops|Dick Vitale's 'Awesome, Baby!' College Hoops||
Dino Dini's Soccer|Dino Dini's Soccer|Dino Dini's Soccer||
Dino Land|Dino Land|Dino Land||
Disney Collection: Castle of Illusion & Quack Shot|Disney Collection - Castle of Illusion & Quack Shot|Disney Collection, The||
Disney•Pixar A Bug's Life|Bug's Life, A|||
Disney•Pixar Toy Story|Toy Story|Toy Story||
Disney's Aladdin|Disney's Aladdin|Aladdin|Aladdin|
Disney's Ariel the Little Mermaid|Ariel - The Little Mermaid|Ariel the Little Mermaid|Ariel - Little Mermaid, The|
Disney's Beauty and the Beast: Belle's Quest|Beauty and the Beast - Belle's Quest|Beauty and the Beast - Belle's Quest|Beauty and the Beast - Belle's Quest|
Disney's Beauty and the Beast: Roar of the Beast|Beauty and the Beast - Roar of the Beast|Beauty and the Beast - Roar of the Beast|Beauty and the Beast - Roar of the Beast|
Divine Sealing|Divine Sealing|Divine Sealing||
DJ Boy|DJ Boy|DJ Boy||
Doki Doki Penguin Land MD|Doki Doki Penguin Land MD||Doki Doki Penguin Land MD|
Domino|Domino|||
Dominus|Dominus|Dominus||
Donald in Maui Mallard|Donald in Maui Mallard|Donald in Maui Mallard||
Dong Gu Ri Te Chi Jak Jeon||Dong Gu Ri Te Chi Jak Jeon||
Doom Troopers: Mutant Chronicles|Doom Troopers - The Mutant Chronicles|Doom Troopers||
Doraemon: Yume Dorobō to 7-nin no Gozans|Doraemon - Yume Dorobouto 7 Nin No Gozansu|Doraemon - Yume Dorobou to 7 Nin no Gozans||
Double Clutch|Double Clutch|Double Clutch||
Double Dragon 3: The Rosetta Stone|Double Dragon 3 - The Rosetta Stone|Double Dragon 3 - The Arcade Game|Double Dragon 3 - Rosetta Stone, The|
Double Dragon|Double Dragon|Double Dragon||
Double Dragon II: The Revenge|Double Dragon 2 - The Revenge|Double Dragon II - The Revenge||
Double Dragon V: The Shadow Falls|Double Dragon V - The Shadow Falls|Double Dragon V - The Shadow Falls||
Double Dribble: The Playoff Edition|Double Dribble - The Playoff Edition|Double Dribble - The Playoff Edition||
Dragon Ball Z: Buyuu Retsuden|Dragon Ball Z - Buyuu Retsuden|Dragon Ball Z - Buyuu Retsuden||
Dragon Ball Z: L'Appel Du Destin|Dragon Ball Z - L'Appel du Destin|Dragon Ball Z - L'Appel du Destin||
Dragon's Eye Plus Shanghai III|Dragon's Eye - Shanghai 3|Dragon's Eye Plus - Shanghai III||
Dragon's Fury|Dragon's Fury|Dragon's Fury||
Dragon's Lair||Dragon's Lair|Dragon's Lair - The Adventure Continues|
Dragon Slayer: The Legend of Heroes|Dragon Slayer II - The Legend of Heroes|Dragon Slayer - Eiyuu Densetsu||
Dragon Slayer: The Legend of Heroes II|Dragon Slayer II - The Legend of Heroes|Dragon Slayer - Eiyuu Densetsu II||
Dragon's Revenge|Dragon's Revenge|Dragon's Revenge||
Dragon: The Bruce Lee Story|Dragon - The Bruce Lee Story|Dragon - The Bruce Lee Story||
Draxos|Draxos|||
Dream Team USA|Dream Team USA|Dream Team USA||
Dr. Robotnik's Mean Bean Machine|Dr. Robotnik's Mean Bean Machine|Dr. Robotnik's Mean Bean Machine||
Duke Nukem 3D|Duke Nukem 3D|Duke Nukem 3D||
Dune:: Der Kampf um den Wustenplaneten|Dune - Der Kampf um den Wuestenplaneten|Dune II - Kampf um den Wustenplaneten||
Dune: The Battle for Arrakis|Dune - The Battle for Arrakis|Dune II - The Battle for Arrakis|Dune - The Battle for Arrakis|
Dungeons & Dragons: Warriors of the Eternal Sun|D&D - Warriors of the Eternal Sun|Dungeons & Dragons - Warriors of the Eternal Sun||
Dyna Brothers 2|Dyna Brothers 2|Dyna Brothers 2||
Dyna Brothers 2: Sega Channel Special||Dyna Brothers 2 - Sega Channel Special||
Dyna Brothers|Dyna Brothers|Dyna Brothers||
Dynamite Duke|Dynamite Duke|Dynamite Duke||
Dynamite Headdy|Dynamite Headdy|Dynamite Headdy||
EA Hockey|EA Hockey|EA Hockey|EA Hockey|
Earnest Evans|Earnest Evans|Earnest Evans||
Earth Defense||Earth Defense||
Earthworm Jim 2|Earthworm Jim 2|Earthworm Jim 2||
Earthworm Jim|Earthworm Jim|Earthworm Jim||
EA Sports Double Header|EA Sports Double Header|EA Sports Double Header||
Ecco Jr.|ECCO Jr.|Ecco Jr.||
Ecco the Dolphin|ECCO The Dolphin|Ecco the Dolphin||
Ecco the Dolphin II||Ecco the Dolphin II||
Ecco: The Tides of Time|ECCO - The Tides of Time|Ecco - The Tides of Time|ECCO II - Tides of Time, The|
Edge's Genesis Demo|Edge's Genesis Demo|||
Eidolon's Inn Commercial #1|Eidolon's Inn Commercial #1|||
Eidolon's Inn Logo by Pablo|Eidolon's Inn Logo by Pablo|||
Eidolon's Inn Rebirth by Fonzie|Eidolon's Inn Rebirth by Fonzie|||
Elemental Master|Elemental Master|Elemental Master||
Elf Wor|Elf Wor|Elf Wor||
Eliminate Down|Eliminate Down|Eliminate Down||
Elite Demo: Game|Elite Demo - Game|||
Elite Demo: Soaker|Elite Demo - Soaker|||
Elite Demo: Viewer|Elite Demo - Viewer|||
Elite Rip Intro 1|Elite Rip Intro 1|||
Elitserien 95||Elitserien 95||
Elitserien 96||Elitserien 96||
El Viento|El Viento|El. Viento||
Empire of Steel||Empire of Steel||
ESPN Baseball Tonight|ESPN Baseball Tonight|ESPN Baseball Tonight||
ESPN National Hockey Night|ESPN National Hockey Night|ESPN National Hockey Night||
ESPN Speed World|ESPN SpeedWorld|ESPN Speed World||
ESPN Sunday Night NFL|ESPN Sunday Night NFL|ESPN Sunday Night NFL||
ESWAT: City Under Siege||ESWAT - City Under Siege||
ESWAT Cyber Police: City Under Siege|ESWAT Cyber Police - City Under Siege|||
ESWAT Cyber Police|ESWAT Cyber Police|||
Eternal Champions|Eternal Champions|Eternal Champions||
Europa Sensen|Europa Sensen|Europa Sensen||
European Club Soccer|European Club Soccer|European Club Soccer||
Evander Holyfield's 'Real Deal' Boxing||Evander Holyfield's 'Real Deal' Boxing||
Evander Holyfield's Real Deal Boxing|Evander Holyfield's Real Deal Boxing|||
Exile|Exile|Exile||
Exile: Toki no Hazama he||Exile - Toki no Hazama he||
Ex-Mutants|Ex-Mutants|Ex-Mutants||
Exodus|Exodus|||
Exodus: Journey to the Promised Land||Exodus - Journey to the Promised Land||
Exo Squad||Exo Squad||
Exo-Squad|Exo-Squad|||
Ex-Ranza|Ex-Ranza|Ex-Ranza||
F-117 Night Storm|F-117 Night Storm|F-117 Night Storm||
F-117 Stealth: Operation Night Storm||F-117 Stealth - Operation Night Storm||
F-117 Stealth: Operation Night Storm|F-117 Stealth - Operation Night Storm|||
F-15 Strike Eagle II|F-15 Strike Eagle II|F-15 Strike Eagle II||
F1 Circus MD|F1 Circus MD|F1 Circus MD||
F1||F1||
F1 Grand Prix: Nakajima Satoru|F1 Grand Prix - Nakajima Satoru|||
F1 Hero MD|F1 Hero MD|||
F1 Super License: Nakajima Satoru|F1 Super License - Nakajima Satoru|||
F1 World Championship Edition|F1 World Championship Edition|||
F1: World Championship Edition||F1 - World Championship Edition||
F1 World Championship|F1 World Championship|||
F-22 Interceptor: Advanced Tactical Fighter|F-22 Interceptor - Advanced Tactical Fighter|||
F-22 Interceptor|F-22 Interceptor|F-22 Interceptor||
Fairlight Rip Intro 1|Fairlight Rip Intro 1|||
Fairlight Rip Intro 2|Fairlight Rip Intro 2|||
Falcon Conversion by Mark Hermonat|Falcon Conversion by Mark Hermonat|||
Family Feud|Family Feud|Family Feud||
Fantasia|Fantasia|Fantasia||
Fantastic Dizzy|Fantastic Dizzy|Fantastic Dizzy||
Fastest 1|Fastest 1|Fastest 1||
Fatal Fury 2|Fatal Fury 2|Fatal Fury 2||
Fatal Fury|Fatal Fury|Fatal Fury||
Fatal Fury - King of Fighters / Garou Densetsu - shukumei no tatakai|||Fatal Fury|
Fatal Labyrinth|Fatal Labyrinth|Fatal Labyrinth||
Fatal Rewind|Fatal Rewind|Fatal Rewind||
Fatman|Fatman|Fatman||
Feng Kuang Tao Hua Yuan||Feng Kuang Tao Hua Yuan||
Fengshen Yingjiechuan|Fengshen Yingjiechuan|||
Feng Shen Ying Jie Chuan||Feng Shen Ying Jie Chuan||
Ferias Frustradas do Pica-Pau|Ferias Frustradas do Pica-Pau|Ferias Frustradas do Pica-Pau||
Ferrari Grand Prix Challenge|Ferrari Grand Prix Challenge|Ferrari Grand Prix Challenge||
Fever Pitch Soccer|Fever Pitch Soccer|Fever Pitch Soccer||
Fido Dido|Fido Dido|Fido Dido||
FIFA 98: Road to World Cup||FIFA 98 - Road to World Cup||
FIFA International Soccer 96|FIFA International Soccer 96|||
FIFA International Soccer|FIFA International Soccer|FIFA International Soccer||
FIFA Soccer 2000 Gold Edition|FIFA Soccer 2000 Gold Edition|||
FIFA Soccer 95|FIFA Soccer 95|FIFA Soccer 95||
FIFA Soccer '96|FIFA Soccer 96|FIFA Soccer 96||
FIFA Soccer 97||FIFA Soccer 97||
FIFA Soccer 97 Gold Edition|FIFA Soccer 97 Gold Edition|||
FIFA Soccer 98: Road to the World Cup|FIFA Soccer 98 - Road to the World Cup|||
FIFA Soccer 99|FIFA Soccer 99|||
Fighting Masters|Fighting Masters|Fighting Masters||
Final Blow|Final Blow|Final Blow||
Final Fantasy|Final Fantasy|||
Final Zone|Final Zone|||
Fire Mustang|Fire Mustang|Fire Mustang||
Fire Power 2000|||Firepower 2000|
Fire Pro Wrestling Gaiden|Fire Pro Wrestling Gaiden|||
Fire Shark|Fire Shark|Fire Shark||
First Steps With The MegaDrive VDP by Marc Haisenko|First Steps With The MegaDrive VDP by Marc Haisenko|||
Flashback||Flashback|Flashback - Quest for Identity, The|
Flashback: The Quest for Identity||Flashback - The Quest for Identity||
Flashback: The Quest for Identity|Flashback - The Quest for Identity|||
Flash Point||Flash Point||
Flavio's Color Bar Screen|Flavio's Color Bar Screen|||
Flavio's DMA Test|Flavio's DMA Test|||
Flavio's GYM Player V1.0|Flavio's GYM Player V1.0|||
Flavio's Raster Effects Test|Flavio's Raster Effects Test|||
Flicky|Flicky|Flicky||
Flink||Flink||
Flintstones|||Flintstones, The|
Flux||Flux||
Flux for Mega-CD|Flux for Mega-CD|||
FM Editor for GENWINDOWS V0.1|FM Editor for GENWINDOWS V0.1|||
FM Synthesis Chromatic Scale Demo by Uchuusen|FM Synthesis Chromatic Scale Demo by Uchuusen|||
FM Synthesis Demo by Uchuusen|FM Synthesis Demo by Uchuusen|||
FM Synthesis Demo: Unconditional Surrender by Uchuusen|FM Synthesis Demo - Unconditional Surrender by Uchuusen|||
FM Test by DevSter|FM Test by DevSter|||
Foreman for Real||Foreman for Real||
Foreman For Real|Foreman For Real|||
Forgotten Worlds|Forgotten Worlds|Forgotten Worlds||
Forgotten Worlds (World) ()||Forgotten Worlds (World) ()||
Formula One||Formula One||
Frank Thomas Big Hurt Baseball|Frank Thomas Big Hurt Baseball|Frank Thomas Big Hurt Baseball||
Frog Feast|||Frog Feast|
Frogger|Frogger|Frogger||
From TV Animation Slam Dunk: Kyougou Makkou Taiketsu!||From TV Animation Slam Dunk - Kyougou Makkou Taiketsu!||
Fun Car Rally|Fun Car Rally|Fun Car Rally||
Fun 'n Games||Fun 'n Games||
Fun 'n' Games||Fun 'n' Games||
Fun-N-Games|Fun-N-Games|||
Funny World & Balloon Boy|Funny World & Balloon Boy|Funny World & Balloon Boy||
Fushigi no Umi no Nadia|Fushigi no Umi no Nadia|Fushigi no Umi no Nadia||
Futbol Argentino 98: Pasion de Multitudes|Futbol Argentino 98 - Pasion de Multitudes|||
FZ Senki Axis ~ Final Zone||FZ Senki Axis ~ Final Zone||
Gadget Twins||Gadget Twins||
Gaiares|Gaiares|Gaiares||
Gain Ground|Gain Ground|Gain Ground||
Galaxian V1 by DevSter|Galaxian V1 by DevSter|||
Galaxian V2 by DevSter|Galaxian V2 by DevSter|||
Galaxy Force II|Galaxy Force II|Galaxy Force II||
Gambler Jiko Chuushinha: Katayama Masayuki no Mahjong Doujou||Gambler Jiko Chuushinha - Katayama Masayuki no Mahjong Doujou||
Gambler Jiko Chuushinha: Katayama Masayuki no Mahjong Doujou|Gambler Jiko Chuushinha - Katayama Masayuki no Mahjong Doujou|||
Game Genie|Game Genie|Game Genie||
Game no Kandume Otokuyou||Game no Kandume Otokuyou||
Game no Kanzume Otokuyou|Game no Kanzume Otokuyou|||
Game Toshokan||Game Toshokan||
Gamtec Magicard|Gamtec Magicard|||
Garfield: Caught in the Act||Garfield - Caught in the Act||
Garfield: Caught in the Act|Garfield - Caught in the Act|||
Gargoyles|Gargoyles|Gargoyles||
Garou Densetsu 2: Arata-naru Tatakai|Garou Densetsu 2 - Arata-naru Tatakai|||
Garou Densetsu 2: Aratanaru Tatakai||Garou Densetsu 2 - Aratanaru Tatakai||
Garou Densetsu: Shukumei no Tatakai||Garou Densetsu - Shukumei no Tatakai||
Garou Densetsu: Shukumei no Tatakai|Garou Densetsu - Shukumei no Tatakai|||
Garry Kitchen's Super Battletank: War in the Gulf||Garry Kitchen's Super Battletank - War in the Gulf||
Gauntlet 4|Gauntlet 4|||
Gauntlet|Gauntlet|Gauntlet||
Gauntlet IV||Gauntlet IV||
Gemfire||Gemfire||
GemFire|GemFire|||
Gem Quest V0.9 by Haroldo de Oliveira Pinheiro|Gem Quest V0.9 by Haroldo de Oliveira Pinheiro|||
General Chaos Daikonsen||General Chaos Daikonsen||
General Chaos|General Chaos|General Chaos||
Generations Lost|Generations Lost|Generations Lost||
Genesis 6-Pak|Genesis 6-Pak|||
Genesis TMSS BIOS|Genesis TMSS BIOS|||
Genghis Khan II: Clan of the Gray Wolf||Genghis Khan II - Clan of the Gray Wolf||
Genghis Khan II: Clan of the Gray Wolf|Genghis Khan II - Clan of the Gray Wolf|||
Genitile Demo by Pascal Bosquet|Genitile Demo by Pascal Bosquet|||
George Foreman's KO Boxing|George Foreman's KO Boxing|George Foreman's KO Boxing||
Ghostbusters|Ghostbusters|Ghostbusters||
Ghostbusters (World) ()||Ghostbusters (World) ()||
Ghost Hunter|Ghost Hunter|||
Ghouls 'n Ghosts||Ghouls 'n Ghosts||
Ghouls 'N Ghosts|Ghouls 'N Ghosts|||
Ghouls'n Ghosts|||Ghouls 'N Ghosts Rev 01|
Ghouls'n Ghosts Rev 2|||Ghouls 'N Ghosts Rev 02|
Global Gladiators||Global Gladiators||
G-LOC Air Battle|G-LOC Air Battle|G-LOC Air Battle||
Gods|Gods|Gods||
Golden Axe|Golden Axe|Golden Axe|Golden Axe Rev 01|
Golden Axe II|Golden Axe II|Golden Axe II||
Golden Axe III|Golden Axe III|Golden Axe III||
Golden Axe Rev 00|||Golden Axe Rev 00|
Golden Axe (World) ()||Golden Axe (World) ()||
Goofy's Hysterical History Tour|Goofy's Hysterical History Tour|Goofy's Hysterical History Tour||
Gouketsuji Ichizoku||Gouketsuji Ichizoku||
Granada|Granada|Granada||
Granada (Japan, USA) ()||Granada (Japan, USA) ()||
Grand Slam Tennis|Grand Slam Tennis|||
GrandSlam: The Tennis Tournament '92||GrandSlam - The Tennis Tournament '92||
GrandSlam: The Tennis Tournament||GrandSlam - The Tennis Tournament||
Graphics & Joystick Sampler by Charles Doty|Graphics & Joystick Sampler by Charles Doty|||
Great Circus Mystery: Mickey to Minnie Magical Adventure 2||Great Circus Mystery - Mickey to Minnie Magical Adventure 2||
Great Circus Mystery, The: Starring Mickey & Minnie|Great Circus Mystery, The - Starring Mickey & Minnie|||
Greatest Heavyweights||Greatest Heavyweights||
Greatest Heavyweights of the Ring|Greatest Heavyweights of the Ring|||
Greendog: The Beached Surfer Dude|Greendog - The Beached Surfer Dude|||
Greendog: The Beached Surfer Dude!||Greendog - The Beached Surfer Dude!||
Green Rotating No Stretching XOR Palette Demo by DevSter|Green Rotating No Stretching XOR Palette Demo by DevSter|||
Green Rotating XOR Palette Demo by DevSter|Green Rotating XOR Palette Demo by DevSter|||
Grind Stormer||Grind Stormer||
GRIND Stormer|GRIND Stormer|||
Growl|Growl|Growl||
Gunship|Gunship|Gunship||
Gunstar Heroes|Gunstar Heroes|Gunstar Heroes||
Gynoug|Gynoug|Gynoug||
Happy Bug Day by Kaneda|Happy Bug Day by Kaneda|||
HardBall '94|HardBall '94|HardBall '94||
HardBall '95|HardBall '95|HardBall '95||
HardBall!|HardBall!|HardBall!||
HardBall III|HardBall III|HardBall III||
Hard Drivin'|Hard Drivin'|Hard Drivin'||
Hard Wired|Hard Wired|||
Harry Potter|Harry Potter|||
Haunting Starring Polterguy|Haunting Starring Polterguy|Haunting Starring Polterguy||
Havoc||Havoc||
Head-On Soccer|Head-On Soccer|Head-On Soccer||
Heavy Nova|Heavy Nova|Heavy Nova||
Heavy Unit|Heavy Unit|||
Heavy Unit: Mega Drive Special||Heavy Unit - Mega Drive Special||
Heavy Unit: Mega Drive Special|||Pyramid Magic Special|
Hei Tao 2: Super Big 2||Hei Tao 2 - Super Big 2||
Hellfire|Hellfire|Hellfire||
Hentai Collection 1|Hentai Collection 1|||
Hercules 2|Hercules 2|||
Hercules|Hercules|||
Herzog Zwei|Herzog Zwei|Herzog Zwei||
High School Soccer: Kunio Kun|High School Soccer - Kunio Kun|||
High Seas Havoc|High Seas Havoc|High Seas Havoc||
Hit the Ice||Hit the Ice||
Hit The Ice|Hit The Ice|||
Hokuto no Ken|Hokuto no Ken|||
Hokuto no Ken: Shin Seikimatsu Kyuuseishu Densetsu||Hokuto no Ken - Shin Seikimatsu Kyuuseishu Densetsu||
Home Alone 2: Lost in New York||Home Alone 2 - Lost in New York||
Home Alone 2: Lost in New York|Home Alone 2 - Lost in New York|||
Home Alone|Home Alone|Home Alone||
Honoo no Toukyuuji Dodge Danpei|Honoo no Toukyuuji Dodge Danpei|Honoo no Toukyuuji Dodge Danpei||
Hook|Hook|Hook||
Hot Chick by DevSter|Hot Chick by DevSter|||
Hot Chick Drawn Without the SH2s for Emulators by DevSter|Hot Chick Drawn Without the SH2s for Emulators by DevSter|||
Hot Chick Drawn Without the SH2s for Hardware by DevSter|Hot Chick Drawn Without the SH2s for Hardware by DevSter|||
Hot Chick in High Quality 15BPP by DevSter|Hot Chick in High Quality 15BPP by DevSter|||
Hot Chick in VDP Mode 2 by DevSter|Hot Chick in VDP Mode 2 by DevSter|||
Hot Chick in VDP Mode 3 by DevSter|Hot Chick in VDP Mode 3 by DevSter|||
Hot Chick Spinning Demo by DevSter|Hot Chick Spinning Demo by DevSter|||
Hot Chick Spinning Slower Demo by DevSter|Hot Chick Spinning Slower Demo by DevSter|||
Hot Chick with Genesis VDP Overlay by DevSter|Hot Chick with Genesis VDP Overlay by DevSter|||
Hot Chick Zoom Shot by DevSter|Hot Chick Zoom Shot by DevSter|||
How to Use Map by Kaneda|How to Use Map by Kaneda|||
Hua Mu Lan: Mulan||Hua Mu Lan - Mulan||
Huan Le Tao Qi Shu: Smart Mouse||Huan Le Tao Qi Shu - Smart Mouse||
Hurricanes|Hurricanes|Hurricanes||
Hyokkori Hyoutanjima: Daitouryou wo Mezase!||Hyokkori Hyoutanjima - Daitouryou wo Mezase!||
Hyokkori Hyoutanjima|Hyokkori Hyoutanjima|||
Hyper Dunk||Hyper Dunk||
Hyper Dunk: The Playoff Edition||Hyper Dunk - The Playoff Edition||
Hyper Dunk: The Playoff Edition|Hyper Dunk - The Playoff Edition|||
Hyper Marbles|Hyper Marbles|Hyper Marbles|Hyper Marbles|
Ice Age Movie Demo|Ice Age Movie Demo|||
Ichidant R|Ichidant R|||
Ikazuse! Koi no Doki Doki Penguin Land MD||Ikazuse! Koi no Doki Doki Penguin Land MD||
I Love Mickey & Donald: Fushigi na Magic Box|I Love Mickey & Donald - Fushigi na Magic Box|||
I Love Mickey Mouse: Fushigi no Oshiro Dai Bouken|I Love Mickey Mouse - Fushigi no Oshiro Dai Bouken|||
IMG International Tour Tennis|IMG International Tour Tennis|IMG International Tour Tennis||
Indiana Jones and the Last Crusade|Indiana Jones and the Last Crusade|Indiana Jones and the Last Crusade||
Insector X|Insector X|Insector X||
Instruments of Chaos Starring Young Indiana Jones||Instruments of Chaos Starring Young Indiana Jones||
International Rugby|International Rugby|International Rugby||
International Superstar Soccer Deluxe|International Superstar Soccer Deluxe|International Superstar Soccer Deluxe||
Iraq War 2003|Iraq War 2003|||
Ironman Ivan Stewart's Super Off-Road|||Ivan Iron Man Stewart's Super Off Road|
Ishido: The Way of Stones||Ishido - The Way of Stones||
Ishido: The Way of the Stones|Ishido - The Way of the Stones|||
It Came from the Desert||It Came from the Desert||
It Came From The Desert|It Came From The Desert|||
Izzy's Quest for the Olympic Rings|Izzy's Quest for the Olympic Rings|Izzy's Quest for the Olympic Rings||
Jack Nicklaus' Power Challenge Golf|Jack Nicklaus' Power Challenge Golf|Jack Nicklaus' Power Challenge Golf||
James Bond 007: The Duel||James Bond 007 - The Duel||
James Bond 007: The Duel|James Bond 007 - The Duel|||
James Bond 007: The Duel|James Bond 007 - The Duel||James Bond 007 - The Duel|
James 'Buster' Douglas Knockout Boxing||James 'Buster' Douglas Knockout Boxing||
James Buster Douglas Knock Out Boxing|James Buster Douglas Knock Out Boxing|||
James Pond 3||James Pond 3||
James Pond 3: Operation Starfish|James Pond 3 - Operation Starfish|||
James Pond II: Codename RoboCod|James Pond II - Codename RoboCod|||
James Pond II: CodeRobocod||James Pond II - CodeRobocod||
James Pond: Underwater Agent||James Pond - Underwater Agent||
James Pond: Underwater Agent|James Pond - Underwater Agent|||
Jammit|Jammit|Jammit||
Janou Touryumon|Janou Touryumon|||
Janou Touryuumon||Janou Touryuumon||
Jantei Monogatari|Jantei Monogatari|Jantei Monogatari||
Jashin Draxos||Jashin Draxos||
Jelly Boy|Jelly Boy|Jelly Boy||
Jennifer Capriati Tennis|Jennifer Capriati Tennis|Jennifer Capriati Tennis||
Jeopardy!: Deluxe Edition||Jeopardy! - Deluxe Edition||
Jeopardy! Deluxe|Jeopardy! Deluxe|||
Jeopardy!|Jeopardy!|Jeopardy!||
Jeopardy! Sports Edition|Jeopardy! Sports Edition|||
Jeopardy!: Sports Edition||Jeopardy! - Sports Edition||
Jerry Glanville's Pigskin Footbrawl|Jerry Glanville's Pigskin Footbrawl|Jerry Glanville's Pigskin Footbrawl||
Jewel Master|Jewel Master|Jewel Master||
Jimmy White's Whirlwind Snooker|Jimmy White's Whirlwind Snooker|Jimmy White's Whirlwind Snooker||
Jim Power: The Arcade Game||Jim Power - The Arcade Game||
Jim Power: The Arcade Game|Jim Power - The Arcade Game|||
Jiu Ji Ma Jiang II: Ye Yan Bian||Jiu Ji Ma Jiang II - Ye Yan Bian||
Jizz Wars|Jizz Wars|||
J. League Champion Soccer|J. League Champion Soccer|J. League Champion Soccer||
J. League Pro Striker 2|J. League Pro Striker 2|J. League Pro Striker 2||
J. League Pro Striker Final Stage|J. League Pro Striker Final Stage|J. League Pro Striker Final Stage||
J. League Pro Striker (Japan) ()||J. League Pro Striker (Japan) ()||
J. League Pro Striker|J. League Pro Striker|||
J. League Pro Striker: Perfect Edition|J. League Pro Striker - Perfect Edition|||
J. League Pro Striker Perfect||J. League Pro Striker Perfect||
Joe & Mac Caveman Ninja|Joe & Mac Caveman Ninja|||
Joe & Mac||Joe & Mac||
Joe Montana Football|Joe Montana Football|Joe Montana Football||
Joe Montana II Sports Talk Football||Joe Montana II Sports Talk Football||
Joe Montana Sports Talk Football 2|Joe Montana Sports Talk Football 2|||
Joe Montana Sports Talk Football|Joe Montana Sports Talk Football|||
John Madden Football '92|John Madden Football '92|John Madden Football '92||
John Madden Football '93: Championship Edition|John Madden Football '93 - Championship Edition|||
John Madden Football '93|John Madden Football '93|John Madden Football '93||
John Madden Football: Championship Edition||John Madden Football - Championship Edition||
John Madden Football|John Madden Football|John Madden Football||
John Madden Football: Pro Football||John Madden Football - Pro Football||
John Madden NFL 94|John Madden NFL 94|||
Jordan vs Bird||Jordan vs Bird||
Jordan vs Bird: One on One||Jordan vs Bird - One on One||
Jordan vs Bird: Super One-on-One|Jordan vs Bird - Super One-on-One|||
Jordan vs Bird (USA, Europe) ()||Jordan vs Bird (USA, Europe) ()||
Joshua & the Battle of Jericho|Joshua & the Battle of Jericho|||
Joshua & The Battle of Jericho||Joshua & The Battle of Jericho||
Journey From Darkness: Strider Returns|Journey From Darkness - Strider Returns|||
Joystick Test Program|Joystick Test Program|||
Judge Dredd||Judge Dredd||
Judge Dredd: The Movie|Judge Dredd - The Movie|||
JuJu Densetsu|JuJu Densetsu|||
JuJu Densetsu ~ Toki: Going Ape Spit||JuJu Densetsu ~ Toki - Going Ape Spit||
Jump'n'Run V1.0 by Kaneda|Jump'n'Run V1.0 by Kaneda|||
Jump'n'Run V1.1 by Kaneda|Jump'n'Run V1.1 by Kaneda|||
Jump'n'Run V1.2 by Kaneda|Jump'n'Run V1.2 by Kaneda|||
Jump'n'Run V2.0 by Kaneda|Jump'n'Run V2.0 by Kaneda|||
Jump'n'Run Vx.x by Kaneda|Jump'n'Run Vx.x by Kaneda|||
Jum's Genny PSG Jukebox|Jum's Genny PSG Jukebox|||
Junction|Junction|Junction||
Jungle Demo by Charles Coty|Jungle Demo by Charles Coty|||
Jungle Strike|Jungle Strike|Jungle Strike||
Jungle Strike: Uketsugareta Kyouki||Jungle Strike - Uketsugareta Kyouki||
Junker's High||Junker's High||
Junkers High|Junkers High|||
Jurassic Park 2: The Lost World|Jurassic Park 2 - The Lost World|||
Jurassic Park|Jurassic Park|Jurassic Park||
Jurassic Park: Rampage Edition||Jurassic Park - Rampage Edition||
Jurassic Park: Rampage Edition|Jurassic Park - Rampage Edition|||
Justice League Task Force|Justice League Task Force|Justice League Task Force||
Juuouki (Japan) ()||Juuouki (Japan) ()||
Juuouki||Juuouki||
Juu-Ou-Ki|Juu-Ou-Ki|||
Ka-Ge-Ki: Fists of Steel||Ka-Ge-Ki - Fists of Steel||
Ka-Ge-Ki: Fists of Steel|Ka-Ge-Ki - Fists of Steel|||
Ka-Ge-Ki|Ka-Ge-Ki|Ka-Ge-Ki||
Kawasaki Superbike Challenge|Kawasaki Superbike Challenge|Kawasaki Superbike Challenge||
Kick Off 3: European Challenge||Kick Off 3 - European Challenge||
Kick Off 3: European Challenge|Kick Off 3 - European Challenge|||
Kid Chameleon|Kid Chameleon|Kid Chameleon||
Kidou Keisatsu Patlabor: 98-Shiki Kidou Seyo!||Kidou Keisatsu Patlabor - 98-Shiki Kidou Seyo!||
King Colossus|King Colossus|||
King of the Monsters 2|King of the Monsters 2|King of the Monsters 2||
King of the Monsters|King of the Monsters|King of the Monsters||
King Salmon||King Salmon||
King Salmon: The Big Catch||King Salmon - The Big Catch||
King Salmon: The Big Catch|King Salmon - The Big Catch|||
King's Bounty|King's Bounty|||
King's Bounty: The Conqueror's Quest||King's Bounty - The Conqueror's Quest||
King Series 18-in-1 KC1801|King Series 18-in-1 KC1801|||
Kishi Densetsu|Kishi Densetsu|Kishi Densetsu||
Kiss Shot||Kiss Shot||
Klax|Klax|Klax||
Knuckles' Chaotix|Knuckles' Chaotix|||
Kokushin V0.10|Kokushin V0.10|||
Kokushin V0.11|Kokushin V0.11|||
Kolibri|Kolibri|||
Koutetsu Teikoku|Koutetsu Teikoku|Koutetsu Teikoku||
Krusty's Super Funhouse|Krusty's Super Funhouse|||
Krusty's Super Fun House||Krusty's Super Fun House||
Krusty's Super Fun House (USA, Europe) ()||Krusty's Super Fun House (USA, Europe) ()||
Kujaku Ou 2: Geneijou||Kujaku Ou 2 - Geneijou||
Kujaku Ou 2|Kujaku Ou 2|||
Kuuga: Operation Code 'Vapor Trail'||Kuuga - Operation Code 'Vapor Trail'||
Kuuga: Operation Vapor Trail|Kuuga - Operation Vapor Trail|||
Kyuukai Douchuuki|Kyuukai Douchuuki|Kyuukai Douchuuki||
Kyuukyoku Tiger||Kyuukyoku Tiger||
Kyuukyou Tiger|Kyuukyou Tiger|||
Labyrinth of Death|Labyrinth of Death||Labyrinth of Death|
Lakers versus Celtics and the NBA Playoffs||Lakers versus Celtics and the NBA Playoffs||
Lakers vs Celtics and the NBA Playoffs|Lakers vs Celtics and the NBA Playoffs|||
Landstalker: Die Schatze von Konig Nolo||Landstalker - Die Schatze von Konig Nolo||
Landstalker: Koutei no Zaihou||Landstalker - Koutei no Zaihou||
Landstalker: Koutei no Zaihou|Landstalker - Koutei no Zaihou|||
Landstalker||Landstalker||
Landstalker: Le Tresor du Roi Nole||Landstalker - Le Tresor du Roi Nole||
Landstalker: The Treasures of King Nole||Landstalker - The Treasures of King Nole||
Landstalker: The Treasures of King Nole|Landstalker - The Treasures of King Nole|||
Langrisser II (Japan) ()||Langrisser II (Japan) ()||
Langrisser II|Langrisser II|Langrisser II||
Langrisser|Langrisser|Langrisser||
La Russa Baseball 95||La Russa Baseball 95||
Last Action Hero|Last Action Hero|Last Action Hero|Last Action Hero|
Last Battle|Last Battle|Last Battle||
Laudate Nomen Domini by Uchuusen|Laudate Nomen Domini by Uchuusen|||
Leander|||Leander|
Legende de Thor, La||Legende de Thor, La||
Lemmings 2: The Tribes||Lemmings 2 - The Tribes||
Lemmings 2: The Tribes|Lemmings 2 - The Tribes|||
Lemmings 2: The Tribes|||Lemmings 2 - Tribes, The|
Lemmings (Japan, USA) ()||Lemmings (Japan, USA) ()||
Lemmings|Lemmings|Lemmings||
Lethal Enforcers II: Gun Fighters|||Lethal Enforcers II - Gun Fighters|
Lethal Enforcers II: Gun Fighters||Lethal Enforcers II - Gun Fighters||
Lethal Enforcers II: Gun Fighters|Lethal Enforcers II - Gun Fighters|||
Lethal Enforcers|Lethal Enforcers|Lethal Enforcers||
LHX Attack Chopper|LHX Attack Chopper|LHX Attack Chopper||
Liberty or Death|Liberty or Death|Liberty or Death||
Light Crusader|Light Crusader|Light Crusader||
Lightening Force: Quest for the Darkstar||Lightening Force - Quest for the Darkstar||
Lightening Force: Quest for the Darkstar|Lightening Force - Quest for the Darkstar|||
Link Dragon|Link Dragon|||
Lion King 3|Lion King 3|||
Lion King|||Lion King, The|
Lobo||Lobo||
Long||Long||
Lord Monarch|Lord Monarch|||
Lord Monarch: Tokoton Sentou Densetsu||Lord Monarch - Tokoton Sentou Densetsu||
Lost World, The: Jurassic Park||Lost World, The - Jurassic Park||
Lotus II||Lotus II||
Lotus II RECS|Lotus II RECS|||
Lotus Turbo Challenge 2|||Lotus Turbo Challenge 2|
Lotus Turbo Challenge|Lotus Turbo Challenge|Lotus Turbo Challenge||
M-1 Abrams Battle Tank|M-1 Abrams Battle Tank|||
M-1 Abrams Battle Tank|M-1 Abrams Battle Tank|M-1 Abrams Battle Tank||
M6|||M6|
Madden NFL '94||Madden NFL '94||
Madden NFL 95|Madden NFL 95|Madden NFL 95||
Madden NFL 96|Madden NFL 96|Madden NFL 96||
Madden NFL 97|Madden NFL 97|Madden NFL 97||
Madden NFL 98|Madden NFL 98|Madden NFL 98||
Madō Monogatarii I|Madou Monogatari I|Madou Monogatari I||
Madonna Songs for 50HZ|Madonna Songs for 50HZ|||
Magical Christmas Greetings Demo|Magical Christmas Greetings Demo|||
Magical Hat no Buttobi Turbo! Daibouken|Magical Hat no Buttobi Turbo! Daibouken|Magical Hat no Buttobi Turbo! Daibouken||
Magical Rip Intro 1|Magical Rip Intro 1|||
Magical Rip Intro 2|Magical Rip Intro 2|||
Magical Rip Intro 3|Magical Rip Intro 3|||
Magical Rip Intro 4|Magical Rip Intro 4|||
Magical Rip Intro 5|Magical Rip Intro 5|||
Magical Rip Intro 6|Magical Rip Intro 6|||
Magical Taruruuto-kun||Magical Taruruuto-kun||
Magical Taruruuto-Kun|Magical Taruruuto-Kun|||
Magic Girl|Magic Girl|||
Mahjong Cop Ryuu: Shiro Ookami no Yabou||Mahjong Cop Ryuu - Shiro Ookami no Yabou||
Mahjong Cop Ryuu: Shiro Ookami no Yabou|Mahjong Cop Ryuu - Shiro Ookami no Yabou|||
Mahjong Lover|Mahjong Lover|||
Ma Jiang Qing Ren: Ji Ma Jiang Zhi||Ma Jiang Qing Ren - Ji Ma Jiang Zhi||
MakeSND Demo by Kaneda|MakeSND Demo by Kaneda|||
Mamono Hunter Yohko: Makai Kara no Tenkosei|Mamono Hunter Yohko - Makai Kara no Tenkosei|||
Mamono Hunter Youko: Dai 7 no Keishou||Mamono Hunter Youko - Dai 7 no Keishou||
Man Overboard!||Man Overboard!||
Man Overboard!: S.S. Lucifer|Man Overboard! - S.S. Lucifer|||
Maou Renjishi|Maou Renjishi|Maou Renjishi||
Ma Qiao E Mo Ta: Devilish Mahjong Tower||Ma Qiao E Mo Ta - Devilish Mahjong Tower||
Marble Madness|Marble Madness|Marble Madness||
Mario Andretti Racing|Mario Andretti Racing|Mario Andretti Racing||
Mario Lemieux Hockey|Mario Lemieux Hockey|Mario Lemieux Hockey||
Marko||Marko|Marko|
Marko's Magic Football|Marko's Magic Football|Marko's Magic Football||
Mars Check Program V1.0|Mars Check Program V1.0|||
Mars Sample Program: Egypt|Mars Sample Program - Egypt|||
Mars Sample Program: Gnu Sierra|Mars Sample Program - Gnu Sierra|||
Mars Sample Program: Runlength Mode Test|Mars Sample Program - Runlength Mode Test|||
Mars Sample Program: SOJ|Mars Sample Program - SOJ|||
Mars Sample Program: Texture Test|Mars Sample Program - Texture Test|||
Marsupilami|Marsupilami|Marsupilami||
Marvel Land|Marvel Land|Marvel Land|Mallet Legend|
Mary Shelley's Frankenstein|Mary Shelley's Frankenstein|Mary Shelley's Frankenstein||
Master of Monsters|Master of Monsters|Master of Monsters||
Master of Weapon|Master of Weapon|Master of Weapon||
Maten Densetsu|Maten Densetsu|||
Maten no Soumetsu||Maten no Soumetsu||
Math Blaster: Episode 1||Math Blaster - Episode 1||
Math Blaster: Episode 1|Math Blaster - Episode 1|||
Matrix Movie Intro|Matrix Movie Intro|||
Maui Mallard in Cold Shadow|||Maui Mallard in Cold Shadow|
Mazin Saga|Mazin Saga|Mazin Saga||
Mazin Saga: Mutant Fighter||Mazin Saga - Mutant Fighter||
Mazin Wars|Mazin Wars|Mazin Wars||
McDonald's Treasure Land Adventure|McDonald's Treasure Land Adventure|McDonald's Treasure Land Adventure||
Medal City||Medal City||
Mega Anser|Mega Anser|Mega Anser||
Mega Bomberman: 8 Player Demo|Mega Bomberman - 8 Player Demo|||
Mega Bomberman|Mega Bomberman|Mega Bomberman||
Mega-CD Model 1 BIOS V1.00|Mega-CD Model 1 BIOS V1.00|||
Mega-CD Model 1 BIOS V1.01|Mega-CD Model 1 BIOS V1.01|||
Mega-CD Model 2 BIOS V2.00|Mega-CD Model 2 BIOS V2.00|||
Mega Games 10||10 Super Jogos||
Mega Games 10 in 1|Mega Games 10 in 1|||
Mega Games 2|Mega Games 2|Mega Games 2||
Mega Games 3|Mega Games 3|Mega Games 3||
Mega Games 6|Mega Games 6|Mega Games 6||
Mega Games 6 Vol. 2||Mega Games 6 Vol. 2||
Mega Games 6 Vol. 3||Mega Games 6 Vol. 3||
Mega Games I|Mega Games I|Mega Games I||
Mega-Lo-Mania (Europe) ()||Mega-Lo-Mania (Europe) ()||
Mega-Lo-Mania||Mega-Lo-Mania||
Mega Lo Mania|Mega Lo Mania|Mega Lo Mania||
Megaman: The Wily Wars|Megaman - The Wily Wars|||
Mega Man: The Wily Wars||Mega Man - The Wily Wars||
MegaMind||MegaMind||
MegaNet BIOS|MegaNet BIOS|||
MegaNet||MegaNet||
Megapanel|Megapanel|||
MegaPanel||MegaPanel||
Mega Q: The Party Quiz Game|Mega Q - The Party Quiz Game|||
Mega SWIV|Mega SWIV|Mega SWIV||
MegaTrax||MegaTrax||
MegaTraX|MegaTraX|||
Mega Turrican|Mega Turrican|Mega Turrican||
Mega Twins|||Mega Twins|
Menacer 6-Game Cartridge||Menacer 6-Game Cartridge||
Menacer 6-in-1 Game Pack|Menacer 6-in-1 Game Pack|||
Menghuan Shuigõ Pan: 777 Casino|777 Casino||777 Casino|
Meng Huan Shui Guo Pan: 777 Casino||Meng Huan Shui Guo Pan - 777 Casino||
Mercs|Mercs|||
Metal Fangs|Metal Fangs|Metal Fangs||
Metal Head|Metal Head|||
Michael Jackson's Moonwalker|Michael Jackson's Moonwalker|Michael Jackson's Moonwalker||
Mickey Mania|||Mickey Mania|
Mickey Mania: The Timeless Adventures of Mickey Mouse||Mickey Mania - The Timeless Adventures of Mickey Mouse||
Mickey Mania: Timeless Adventures of Mickey Mouse|Mickey Mania - Timeless Adventures of Mickey Mouse|||
Mickey Mouse: Minnie's Magical Adventure 2|Mickey Mouse - Minnie's Magical Adventure 2|||
Mickey's Ultimate Challenge|Mickey's Ultimate Challenge|Mickey's Ultimate Challenge||
Mick & Mack as the Global Gladiators|Mick & Mack as the Global Gladiators|Mick & Mack as the Global Gladiators||
Micro Machines 2: Turbo Tournament||Micro Machines 2 - Turbo Tournament||
Micro Machines 2: Turbo Tournament|Micro Machines 2 - Turbo Tournament|||
Micro Machines|Micro Machines|Micro Machines|Micro Machines|
Micro Machines Military: It's a Blast!|Micro Machines Military - It's a Blast!|||
Micro Machines Military||Micro Machines Military||
Micro Machines Turbo Tournament 96 (Europe) ()||Micro Machines Turbo Tournament 96 (Europe) ()||
Micro Machines Turbo Tournament 96||Micro Machines Turbo Tournament 96||
Micro Machines: Turbo Tournament '96|Micro Machines - Turbo Tournament '96|||
Midnight Resistance|Midnight Resistance|Midnight Resistance||
Midway Presents Arcade's Greatest Hits||Midway Presents Arcade's Greatest Hits||
Mig-29 Fighter Pilot|Mig-29 Fighter Pilot|Mig-29 Fighter Pilot||
Might and Magic: Gates to Another World||Might and Magic - Gates to Another World||
Might and Magic: Gates to Another World|Might and Magic - Gates to Another World|||
Might and Magic III: Isles of Terra||Might and Magic III - Isles of Terra||
Might and Magic III: Isles of Terra|Might and Magic III - Isles of Terra|||
Mighty Max|||Mighty Max|
Mighty Mighty Missile 2004 by Fonzie|Mighty Mighty Missile 2004 by Fonzie|||
Mighty Morphin Power Rangers|Mighty Morphin Power Rangers|Mighty Morphin Power Rangers||
Mighty Morphin Power Rangers: The Movie||Mighty Morphin Power Rangers - The Movie||
Mighty Morphin Power Rangers: The Movie|Mighty Morphin Power Rangers - The Movie|||
Mike Ditka Power Football|Mike Ditka Power Football|Mike Ditka Power Football||
Minato no Toreijia|Minato no Toreijia|||
Minato no Traysia||Minato no Traysia||
Mine Demo V0.01|Mine Demo V0.01|||
Mine Demo V0.02|Mine Demo V0.02|||
Mine Demo V0.03|Mine Demo V0.03|||
Minnesota Fats Pool Legend|Minnesota Fats Pool Legend|||
Minnesota Fats: Pool Legend||Minnesota Fats - Pool Legend||
Miracle Piano Teaching System|Miracle Piano Teaching System|||
MK 5: Mortal Combat: SubZero|MK 5 - Mortal Combat - SubZero|||
MLBPA Baseball|MLBPA Baseball|MLBPA Baseball||
MLBPA Sports Talk Baseball|MLBPA Sports Talk Baseball|||
Monk and Monkeys by Fonzie|Monk and Monkeys by Fonzie|||
Monopoly|Monopoly|Monopoly||
Monster World IV|Monster World IV|Monster World IV||
Moonbase V0.04|Moonbase V0.04|||
Moonbase V0.05|Moonbase V0.05|||
Moonbase V0.06|Moonbase V0.06|||
Moonwalker Rev 00|||Moonwalker Rev 00|
Moonwalker Rev 1|||Moonwalker Rev 01|
Mortal Kombat 3|Mortal Kombat 3|Mortal Kombat 3||
Mortal Kombat II|Mortal Kombat II|Mortal Kombat II||
Mortal Kombat|Mortal Kombat|Mortal Kombat||
Mortal Kombat (World) ()||Mortal Kombat (World) ()||
Motocross Championship|Motocross Championship|||
Mr. Nutz Hoppin' Mad||Mr. Nutz Hoppin' Mad||
Mr. Nutz|Mr. Nutz|Mr. Nutz||
Ms. Pac-Man|Ms. Pac-Man|Ms. Pac-Man||
Mugen Senshi Valis||Mugen Senshi Valis|Mugen Senshi Valis|
Muhammad Ali Heavyweight Boxing|Muhammad Ali Heavyweight Boxing|Muhammad Ali Heavyweight Boxing||
Mulan|Mulan|||
Multitap: IO Sample Program|Multitap - IO Sample Program|||
Musha Aleste: Full Metal Fighter Ellinor||Musha Aleste - Full Metal Fighter Ellinor||
Musha Aleste: Full Metal Fighter Ellinor|Musha Aleste - Full Metal Fighter Ellinor|||
MUSHA: Metallic Uniframe Super Hybrid Armor||MUSHA - Metallic Uniframe Super Hybrid Armor||
M.U.S.H.A|M.U.S.H.A|||
Mutant League Football|Mutant League Football|Mutant League Football||
Mutant League Hockey|Mutant League Hockey|Mutant League Hockey||
Mystical Fighter|Mystical Fighter|Mystical Fighter||
Mystic Defender|Mystic Defender|Mystic Defender||
Nakajima Satoru Kanshuu F1 Grand Prix||Nakajima Satoru Kanshuu F1 Grand Prix||
Nakajima Satoru Kanshuu F1 Hero MD||Nakajima Satoru Kanshuu F1 Hero MD||
Nakajima Satoru Kanshuu F1 Super License||Nakajima Satoru Kanshuu F1 Super License||
Name|GoodName|NoIntro|TOSEC|ReDump
Naomichi Ozaki no Super Masters||Naomichi Ozaki no Super Masters||
NBA Action '94||NBA Action '94||
NBA Action '95|NBA Action '95|||
NBA Action '95 Starring David Robinson||NBA Action '95 Starring David Robinson||
NBA Action|NBA Action|||
NBA All-Star Challenge|NBA All-Star Challenge|NBA All-Star Challenge||
NBA Hang Time|NBA Hang Time|NBA Hang Time||
NBA Jam|NBA Jam|NBA Jam||
NBA Jam Tournament Edition|NBA Jam Tournament Edition|NBA Jam Tournament Edition||
NBA Jam (USA, Europe) ()||NBA Jam (USA, Europe) ()||
NBA Live 95|NBA Live 95|NBA Live 95||
NBA Live 96|NBA Live 96|NBA Live 96||
NBA Live 97|NBA Live 97|NBA Live 97||
NBA Live 98|NBA Live 98|NBA Live 98||
NBA Playoff: Bulls vs Blazers|NBA Playoff - Bulls vs Blazers|||
NBA Playoffs: Bulls vs Blazers||NBA Playoffs - Bulls vs Blazers||
NBA Pro Basketball '94|NBA Pro Basketball '94|NBA Pro Basketball '94||
NBA Pro Basketball: Bulls vs Lakers||NBA Pro Basketball - Bulls vs Lakers||
NBA Pro Basketball: Bulls vs Lakers|NBA Pro Basketball - Bulls vs Lakers|||
NBA Showdown '94||NBA Showdown '94||
NBA Showdown 94|NBA Showdown 94|||
NCAA College Football|NCAA College Football|||
NCAA Final Four Basketball||NCAA Final Four Basketball||
NCAA Final Four College Basketball|NCAA Final Four College Basketball|||
NCAA Football||NCAA Football||
Nekketsu Koukou Dodgeball Bu: Soccer Hen MD||Nekketsu Koukou Dodgeball Bu - Soccer Hen MD||
Neozeed Color Demo by Pascal Bosquet|Neozeed Color Demo by Pascal Bosquet|||
New 3D Golf Simulation: Devil's Course||New 3D Golf Simulation - Devil's Course||
New 3D Golf Simulation Harukanaru Augusta|New 3D Golf Simulation Harukanaru Augusta|||
New 3D Golf Simulation: Harukanaru Augusta||New 3D Golf Simulation - Harukanaru Augusta||
New 3D Golf Simulation: Pebble Beach no Hatou||New 3D Golf Simulation - Pebble Beach no Hatou||
New 3D Golf Simulation: Waialae no Kiseki||New 3D Golf Simulation - Waialae no Kiseki||
New Horizons||New Horizons||
Newman Haas Indy Car Featuring Nigel Mansell||Newman Haas Indy Car Featuring Nigel Mansell||
Newman Haas Indy Car|||Newman Haas Indy Car|
Newman-Haas IndyCar Racing|Newman-Haas IndyCar Racing|||
NFL '95|NFL '95|NFL '95||
NFL 98|NFL 98|NFL 98||
NFL Football '94||NFL Football '94||
NFL Football '94 Starring Joe Montana|NFL Football '94 Starring Joe Montana|NFL Football '94 Starring Joe Montana||
NFL Prime Time|NFL Prime Time|||
NFL Quarterback Club 96|NFL Quarterback Club 96|NFL Quarterback Club 96||
NFL Quarterback Club|NFL Quarterback Club|NFL Quarterback Club||
NFL Sports Talk Football '93 Starring Joe Montana||NFL Sports Talk Football '93 Starring Joe Montana||
NHK Taiga Drama: Taiheiki||NHK Taiga Drama - Taiheiki||
NHL '94||NHL '94||
NHL 94|NHL 94|||
NHL 95 Elitserien|NHL 95 Elitserien|||
NHL 95|NHL 95|NHL 95||
NHL 96 Elitserien|NHL 96 Elitserien|||
NHL 96|NHL 96|NHL 96||
NHL 97|NHL 97|NHL 97||
NHL 98|NHL 98|NHL 98||
NHL All-Star Hockey '95|NHL All-Star Hockey '95|NHL All-Star Hockey '95||
NHL Hockey|NHL Hockey|NHL Hockey||
NHLPA Hockey '93|NHLPA Hockey '93|||
NHLPA Hockey 93||NHLPA Hockey 93||
NHLPA Hockey 93 (USA, Europe) ()||NHLPA Hockey 93 (USA, Europe) ()||
Nickelodeon: Aaahh!!! Real Monsters|AAAHH!!! Real Monsters|AAAHH!!! Real Monsters|Aaahh!!! Real Monsters|
Nigel Mansell's World Championship|Nigel Mansell's World Championship|||
Nigel Mansell's World Championship Racing||Nigel Mansell's World Championship Racing||
Nightmare Circus|Nightmare Circus|Nightmare Circus||
Nikkan Sports Pro Yakyuu Van|Nikkan Sports Pro Yakyuu Van|Nikkan Sports Pro Yakyuu Van||
Ninja Burai Densetsu|Ninja Burai Densetsu|Ninja Burai Densetsu||
Ninja Gaiden|Ninja Gaiden|Ninja Gaiden||
Nobunaga no Yabō: Haōden||Nobunaga no Yabou - Haouden||
Nobunaga no Yabou: Bushou Fuuunroku||Nobunaga no Yabou - Bushou Fuuunroku||
Nobunaga no Yabou: Bushou Fuuunsoku|Nobunaga no Yabou - Bushou Fuuunsoku|||
Nobunaga no Yabou Haouden: Lord of Darkness|Nobunaga no Yabou Haouden - Lord of Darkness|||
Nobunaga no Yabou: Zenkokuban|Nobunaga no Yabou - Zenkokuban|||
Nobunaga no Yabou: Zenkoku Ban||Nobunaga no Yabou - Zenkoku Ban||
Nobunaga's Ambition|Nobunaga's Ambition|Nobunaga's Ambition||
No Escape|No Escape|No Escape||
Normy's Beach Babe-O-Rama|Normy's Beach Babe-O-Rama|Normy's Beach Babe-O-Rama||
Old Skill by Kaneda|Old Skill by Kaneda|||
Olympic Gold: Barcelona 92|Olympic Gold - Barcelona 92|||
Olympic Gold||Olympic Gold||
Olympic Summer Games Atlanta 96|Olympic Summer Games Atlanta 96|||
Olympic Summer Games||Olympic Summer Games|Olympic Summer Games|
Olympic Winter Games: Lillehammer 94|Olympic Winter Games - Lillehammer 94|||
Omega Race|Omega Race|||
On Dal Jang Goon||On Dal Jang Goon||
Onslaught|Onslaught|Onslaught||
Ooga Booga! from y2kode: 2nd Version by Kaneda|Ooga Booga! from y2kode - 2nd Version by Kaneda|||
Operation Europe: Path to Victory 1939-1945|Operation Europe - Path to Victory 1939-1945|||
Operation Europe: Path to Victory 1939-45||Operation Europe - Path to Victory 1939-45||
Optimized Rotating XOR Palette Demo by DevSter|Optimized Rotating XOR Palette Demo by DevSter|||
Osomatsu-kun Hachamecha Gekijou||Osomatsu-kun Hachamecha Gekijou||
Osomatsu-kun: Hachamecha Gekijou|Osomatsu-kun - Hachamecha Gekijou|||
Outlander|Outlander|Outlander||
Out of this World|Out of this World|||
Out of This World||Out of This World||
OutRun 2019|OutRun 2019|OutRun 2019||
OutRunners|OutRunners|OutRunners||
OutRun|OutRun|OutRun||
Pac-Attack|Pac-Attack|Pac-Attack||
Pachinko Canyon|Pachinko Canyon|||
Pachinko Kuunyan||Pachinko Kuunyan||
Pac-Man 2: The New Adventures||Pac-Man 2 - The New Adventures||
Pac-Man 2: The New Adventures|Pac-Man 2 - The New Adventures|||
Pac-Mania|Pac-Mania|Pac-Mania||
Pac-Panic||Pac-Panic||
Paddle Fighter|Paddle Fighter|Paddle Fighter|Paddle Fighter|
Panorama Cotton|Panorama Cotton|Panorama Cotton||
Paperboy 2||Paperboy 2||
Paperboy II|Paperboy II|||
Paperboy|Paperboy|Paperboy||
Paradox Intro 1|Paradox Intro 1|||
Party Quiz Mega Q||Party Quiz Mega Q|Party Quiz Mega Q|
Patlabor|Patlabor|||
Pat Riley Basketball|Pat Riley Basketball|Pat Riley Basketball||
PCM Sound Demo by Uchuusen|PCM Sound Demo by Uchuusen|||
Pebble Beach Golf Links|Pebble Beach Golf Links|Pebble Beach Golf Links||
Pebble Beach no Hatou|Pebble Beach no Hatou|||
Pele II: World Tournament Soccer||Pele II - World Tournament Soccer||
Pele!|Pele!|Pele!||
Pele's World Tournament Soccer|Pele's World Tournament Soccer|||
Pengo|Pengo|||
Pepenga Pengo||Pepenga Pengo||
Pete Sampras Tennis 96|Pete Sampras Tennis 96|||
Pete Sampras Tennis|Pete Sampras Tennis|Pete Sampras Tennis||
PGA European Tour|PGA European Tour|PGA European Tour||
PGA Tour '96|PGA Tour 96|PGA Tour 96||
PGA Tour Golf III|PGA Tour Golf III|PGA Tour Golf III||
PGA Tour Golf II|PGA Tour Golf II|PGA Tour Golf II||
PGA Tour Golf II (USA, Europe) ()||PGA Tour Golf II (USA, Europe) ()||
PGA Tour Golf|PGA Tour Golf|||
PGA Tour Golf (USA, Europe) ()||PGA Tour Golf (USA, Europe) ()||
Phantasy Star 2|||Phantasy Star II - Anne's Adventure|
Phantasy Star: End of the Millennium|||Phantasy Star - End of the Millennium, The|
Phantasy Star II: Amia's Adventure||Phantasy Star II - Amia's Adventure||
Phantasy Star II: Anne's Adventure||Phantasy Star II - Anne's Adventure||
Phantasy Star II: Anne's Adventure|Phantasy Star II - Anne's Adventure|||
Phantasy Star II: Huey's Adventure|||Phantasy Star II - Huey's Adventure|
Phantasy Star II: Huey's Adventure||Phantasy Star II - Huey's Adventure||
Phantasy Star II: Huey's Adventure|Phantasy Star II - Huey's Adventure|||
Phantasy Star III: Generations of Doom||Phantasy Star III - Generations of Doom||
Phantasy Star III: Generations of Doom|Phantasy Star III - Generations of Doom|||
Phantasy Star III: Toki no Keishousha||Phantasy Star III - Toki no Keishousha||
Phantasy Star III: Toki no Keishousha|Phantasy Star III - Toki no Keishousha|||
Phantasy Star II: Kaerazaru Toki no Owari ni||Phantasy Star II - Kaerazaru Toki no Owari ni||
Phantasy Star II: Kinds's Adventure|||Phantasy Star II - Kinds's Adventure|
Phantasy Star II: Kinds's Adventure||Phantasy Star II - Kinds's Adventure||
Phantasy Star II: Kinds's Adventure|Phantasy Star II - Kinds's Adventure|||
Phantasy Star II: Nei's Adventure||Phantasy Star II - Nei's Adventure||
Phantasy Star II|Phantasy Star II|Phantasy Star II||
Phantasy Star II: Rudger's Adventure||Phantasy Star II - Rudger's Adventure||
Phantasy Star II: Shilka's Adventure|||Phantasy Star II - Shilka's Adventure|
Phantasy Star II: Shilka's Adventure||Phantasy Star II - Shilka's Adventure||
Phantasy Star II: Shilka's Adventure|Phantasy Star II - Shilka's Adventure|||
Phantasy Star II: Yushis's Adventure||Phantasy Star II - Yushis's Adventure||
Phantasy Star IV||Phantasy Star IV||
Phantasy Star: Sennenki no Owari ni||Phantasy Star - Sennenki no Owari ni||
Phantasy Star: The End of the Millenium|||Phantasy Star|
Phantasy Star: The End of the Millenium|Phantasy Star - The End of the Millenium|||
Phantom 2040|Phantom 2040|Phantom 2040||
Phelios|Phelios|Phelios||
Picture Magic Boot Cart|Picture Magic Boot Cart|||
Pink Goes to Hollywood|Pink Goes to Hollywood|Pink Goes to Hollywood||
Pinocchio|Pinocchio|Pinocchio||
Pioneer LaserActive BIOS V1.02|Pioneer LaserActive BIOS V1.02|||
Pirates! Gold|Pirates! Gold|Pirates! Gold||
Pitfall|Pitfall|||
Pitfall: The Mayan Adventure||Pitfall - The Mayan Adventure||
Pitfall: The Mayan Adventure|Pitfall - The Mayan Adventure|||
Pit Fighter|Pit Fighter|||
Pit-Fighter||Pit-Fighter||
Pocahontas|Pocahontas|Pocahontas||
Pocket Monsters 2|Pocket Monsters 2|||
Pocket Monsters|Pocket Monsters|||
Pokemon Crazy Drummer|Pokemon Crazy Drummer|||
Polygon Test by Haroldo de Oliveira Pinheiro|Polygon Test by Haroldo de Oliveira Pinheiro|||
Pong Demo 6 by Pascal Bosquet|Pong Demo 6 by Pascal Bosquet|||
Pong Demo Code 1 by Pascal Bosquet|Pong Demo Code 1 by Pascal Bosquet|||
Pong Masters Intro 1|Pong Masters Intro 1|||
Populous II: Trials of the Olympian Gods|||Populous II - Trials of the Olympian Gods|
Populous II: Two Tribes|Populous II - Two Tribes|||
Populous|Populous|Populous||
Power Athlete|Power Athlete|Power Athlete||
Powerball|Powerball|Powerball||
Power Drive|Power Drive|Power Drive||
Power Instinct|Power Instinct|||
Power Monger|Power Monger|Power Monger||
Predator 2|Predator 2|Predator 2||
Premiere Rip Intro 1|Premiere Rip Intro 1|||
Premier Manager 97|Premier Manager 97|Premier Manager 97||
Premier Manager|Premier Manager|Premier Manager||
Pretty Girl Mahjongg|Pretty Girl Mahjongg|||
Primal Rage|Primal Rage|Primal Rage||
Prime Time NFL Starring Deion Sanders||Prime Time NFL Starring Deion Sanders||
Prince of Persia 2: The Shadow and the Flame||Prince of Persia 2 - The Shadow and the Flame||
Prince of Persia|Prince of Persia|Prince of Persia||
Pro Action Replay 2||Pro Action Replay 2||
Pro Action Replay 2 V2.1|Pro Action Replay 2 V2.1|||
Pro Action Replay|Pro Action Replay|Pro Action Replay||
Probotector|Probotector|Probotector||
Pro Hockey|Pro Hockey|||
Pro Quarterback|Pro Quarterback|Pro Quarterback||
Pro Yakyuu Super League '91||Pro Yakyuu Super League '91||
Psycho Pinball|Psycho Pinball|Psycho Pinball||
Psycho Sonic by Jen Hedgehog|Psycho Sonic by Jen Hedgehog|||
Psy-O-Blade Moving Adventure|Psy-O-Blade Moving Adventure|||
Psy-O-Blade||Psy-O-Blade||
P.T.O: Pacific Theater of Operations||P.T.O - Pacific Theater of Operations||
P.T.O. Pacific Theater of Operations|P.T.O. Pacific Theater of Operations|||
Puggsy|Puggsy|Puggsy||
Pulseman|Pulseman|Pulseman||
Punisher, The|Punisher, The|Punisher, The||
Putter Golf|Putter Golf|Putter Golf|Putter Golf|
Puyo Puyo 2 (Japan) ()||Puyo Puyo 2 (Japan) ()||
Puyo Puyo 2||Puyo Puyo 2||
Puyo Puyo|Puyo Puyo|Puyo Puyo||
Puyo Puyo Tsu|Puyo Puyo Tsu|||
Puzzle & Action: Ichidanto A-Ru|||Puzzle & Action - Ichidanto A-Ru|
Puzzle & Action: Ichidanto-R||Puzzle & Action - Ichidanto-R||
Puzzle & Action: Tanto-R|||Puzzle & Action - Tanto-R|
Puzzle & Action: Tanto-R||Puzzle & Action - Tanto-R||
Pyramid Magic 2|||Pyramid Magic II|
Pyramid Magic 3|||Pyramid Magic III|
Pyramid Magic III|Pyramid Magic III|Pyramid Magic III||
Pyramid Magic II|Pyramid Magic II|Pyramid Magic II||
Pyramid Magic|Pyramid Magic|Pyramid Magic|Pyramid Magic|
Pyramid Magic Special|Pyramid Magic Special|Pyramid Magic Special||
QuackShot Starring Donald Duck ~ QuackShot: I Love Donald Duck: Guruzia Ou no Hihou||QuackShot Starring Donald Duck ~ QuackShot - I Love Donald Duck - Guruzia Ou no Hihou||
QuackShot Starring Donald Duck ~ QuackShot: I Love Donald Duck: Guruzia Ou no Hihou (World) ()||QuackShot Starring Donald Duck ~ QuackShot - I Love Donald Duck - Guruzia Ou no Hihou (World) ()||
Quack Shot Starring Donald Duck|Quack Shot Starring Donald Duck|||
Quad Challenge|Quad Challenge|Quad Challenge||
Quadrant V0.00|Quadrant V0.00|||
Quadrant V0.01|Quadrant V0.01|||
Quadrant V0.02|Quadrant V0.02|||
Race Drivin'|Race Drivin'|Race Drivin'||
Racing Demo|Racing Demo|||
Radical Rex|Radical Rex|Radical Rex||
Ragnacenty|Ragnacenty|Ragnacenty||
Raiden Densetsu ~ Raiden Trad||Raiden Densetsu ~ Raiden Trad||
Raiden|||Raiden|
Raiden Trad|Raiden Trad|||
Rainbow Islands Extra||Rainbow Islands Extra||
Rainbow Islands: The Story of Bubble Bobble 2|Rainbow Islands - The Story of Bubble Bobble 2|||
Rambo III|Rambo III|Rambo III||
Rambo III (World) ()||Rambo III (World) ()||
Rampart|Rampart|Rampart||
Ranger X||Ranger X||
Ranger-X|Ranger-X|||
Ransei no Hasha|Ransei no Hasha|Ransei no Hasha||
Rastan Saga II|Rastan Saga II|Rastan Saga II||
R.B.I. Baseball 3||R.B.I. Baseball 3||
RBI Baseball 3|RBI Baseball 3|||
R.B.I. Baseball 4||R.B.I. Baseball 4||
RBI Baseball 4|RBI Baseball 4|||
R.B.I. Baseball '93||R.B.I. Baseball '93||
RBI Baseball 93|RBI Baseball 93|||
R.B.I. Baseball '94||R.B.I. Baseball '94||
RBI Baseball 94|RBI Baseball 94|||
RBI Baseball 95|RBI Baseball 95|||
Red Zone|Red Zone|Red Zone||
Ren and Stimpy Show, The: Stimpy's Invention|Ren and Stimpy Show, The - Stimpy's Invention|||
Rent a Hero||Rent a Hero||
Rent A Hero|Rent A Hero|||
Resq|Resq|Resq||
Revenge of Shinobi, The|Revenge of Shinobi, The|Revenge of Shinobi, The||
Revolution X|Revolution X|Revolution X||
Richard Scarry's Busytown|Richard Scarry's Busytown|Richard Scarry's Busytown||
Rick Dangerous Demo by Pascal Bosquet|Rick Dangerous Demo by Pascal Bosquet|||
Riddle Wired||Riddle Wired||
Rings of Power|Rings of Power|Rings of Power||
Rise of the Robots|Rise of the Robots|Rise of the Robots||
Risk|Risk|Risk||
Risky Woods|Risky Woods|Risky Woods||
Ristar|Ristar|Ristar||
Ristar: The Shooting Star||Ristar - The Shooting Star||
Ristar: The Shooting Star|Ristar - The Shooting Star|||
Road Blasters|Road Blasters|||
RoadBlasters||RoadBlasters||
Road Rash 3|Road Rash 3|Road Rash 3||
Road Rash II|Road Rash II|Road Rash II||
Road Rash II (USA, Europe) ()||Road Rash II (USA, Europe) ()||
Road Rash|Road Rash|Road Rash||
Road Wars 2000 V0.07 by Jason Meehan|Road Wars 2000 V0.07 by Jason Meehan|||
Robocop 3|Robocop 3|||
RoboCop 3||RoboCop 3||
Robocop Versus The Terminator|Robocop Versus The Terminator|||
RoboCop versus The Terminator||RoboCop versus The Terminator||
Robot Battler||Robot Battler||
Robot Wreckage|Robot Wreckage|Robot Wreckage||
Rocket Knight Adventures|Rocket Knight Adventures|Rocket Knight Adventures||
Rockman Megaworld|Rockman Megaworld|||
Rockman: Mega World||Rockman - Mega World||
Rockman X3|Rockman X3|||
Rock 'n' Roll Racing||Rock 'n' Roll Racing||
Rock n' Roll Racing|Rock n' Roll Racing|Rock n' Roll Racing||
Rocky and Bullwinkle, The Adventures of|Rocky and Bullwinkle, The Adventures of|||
Roger Clemens' MVP Baseball||Roger Clemens' MVP Baseball||
Roger Clemens' MVP Baseball|Roger Clemens' MVP Baseball|||
Rolling Thunder 2|Rolling Thunder 2|Rolling Thunder 2||
Rolling Thunder 3|Rolling Thunder 3|Rolling Thunder 3||
Rolo to the Rescue|Rolo to the Rescue|Rolo to the Rescue||
Romance of the Three Kingdoms III: Dragon of Destiny||Romance of the Three Kingdoms III - Dragon of Destiny||
Romance of the Three Kingdoms III|Romance of the Three Kingdoms III|||
Romance of the Three Kingdoms II|Romance of the Three Kingdoms II|Romance of the Three Kingdoms II||
Romance of the Three Kingdoms Part 5|Romance of the Three Kingdoms Part 5|||
Ronaldinho 98|Ronaldinho 98|||
Rondoudou by Fonzie|Rondoudou by Fonzie|||
Rotating No Background Fill XOR Palette Demo by DevSter|Rotating No Background Fill XOR Palette Demo by DevSter|||
Rotating Pixel Skipping XOR Palette Demo by DevSter|Rotating Pixel Skipping XOR Palette Demo by DevSter|||
Rotating XOR Palette Demo by DevSter|Rotating XOR Palette Demo by DevSter|||
Royal Blood|Royal Blood|Royal Blood||
RPG Creator V0.01 by Haroldo de Oliveira Pinheiro|RPG Creator V0.01 by Haroldo de Oliveira Pinheiro|||
Rugby World Cup 1995|Rugby World Cup 1995|||
Rugby World Cup 95||Rugby World Cup 95||
Runark|Runark|Runark||
Ryuuko no Ken|Ryuuko no Ken|Ryuuko no Ken||
Sagaia|Sagaia|Sagaia||
Saint Sword|Saint Sword|Saint Sword||
Saludo Navideno 2005 by Tom Maneiro|Saludo Navideno 2005 by Tom Maneiro|||
Same! Same! Same!|Same! Same! Same!|Same! Same! Same!||
Sample Program: Indian Picture|Sample Program - Indian Picture|||
Sampras Tennis 96||Sampras Tennis 96||
Samurai Shodown|Samurai Shodown|Samurai Shodown||
Samurai Spirits|Samurai Spirits|Samurai Spirits||
San Goku Shi 2|||San Goku Shi II|
San Goku Shi 3|||San Goku Shi III|
Sangokushi III|Sangokushi III|Sangokushi III||
Sangokushi II|Sangokushi II|Sangokushi II||
Sangokushi IV|Sangokushi IV|||
Sangokushi Retsuden: Ransei no Eiyuutachi||Sangokushi Retsuden - Ransei no Eiyuutachi||
Sangokushi Retsuden: Ransei no Eiyuu Tachi|Sangokushi Retsuden - Ransei no Eiyuu Tachi|||
Sangokushi Retsuden|Sangokushi Retsuden|||
San Goku Shi Retsuden|||San Goku Shi Retsuden|
San Guo Zhi Lie Zhuan: Luan Shi Qun Ying||San Guo Zhi Lie Zhuan - Luan Shi Qun Ying||
San Guo Zhi V||San Guo Zhi V||
Sansan||Sansan||
Saturday Night Slammasters||Saturday Night Slammasters||
Saturday Night Slam Masters|Saturday Night Slam Masters|||
Scooby Doo Mystery|Scooby Doo Mystery|||
Scooby-Doo Mystery||Scooby-Doo Mystery||
Scoopex Rip Intro 1|Scoopex Rip Intro 1|||
Scrabble|Scrabble|Scrabble||
SD Valis||SD Valis|SD Valis|
SeaQuest DSV|SeaQuest DSV|SeaQuest DSV||
Second Samurai||Second Samurai||
Sega-CD 68K BIOS|Sega-CD 68K BIOS|||
Sega-CD Model 1 BIOS V1.10|Sega-CD Model 1 BIOS V1.10|||
Sega-CD Model 2 BIOS V2.00|Sega-CD Model 2 BIOS V2.00|||
Sega-CD Model 2 BIOS V2.00W Emulated Hoax|Sega-CD Model 2 BIOS V2.00W Emulated Hoax|||
Sega-CD Model 2 BIOS V2.00W|Sega-CD Model 2 BIOS V2.00W|||
Sega-CD Model 2 BIOS V2.11|Sega-CD Model 2 BIOS V2.11|||
Sega-CDX BIOS V2.21|Sega-CDX BIOS V2.21|||
Sega Channel Demo||Sega Channel Demo||
Sega Channel|Sega Channel|Sega Channel||
Sega Genesis 6-Pak|||Sega Genesis 6-Pak|
Sega HMD and Tracker Demo: OA7-TST|Sega HMD and Tracker Demo - OA7-TST|||
Segaleks V0.1 by DevSter|Segaleks V0.1 by DevSter|||
Sega Megadrive Classics 4|Classic Collection|Classic Collection||
Sega Music Joystick Demo|Sega Music Joystick Demo|||
Sega Radica! Volume 1 BIOS|Sega Radica! Volume 1 BIOS|||
Sega Radica! Volume 1|Sega Radica! Volume 1|||
Sega Sports 1|Sega Sports 1|Sega Sports 1||
Sega Subor System Cartridge|Sega Subor System Cartridge|||
Sega Top 5|Sega Top 5|||
Sega Top Five||Sega Top Five||
SegGala Alpha V1.00 by Bill Eubanks|SegGala Alpha V1.00 by Bill Eubanks|||
SegGala V0.06 by Bill Eubanks|SegGala V0.06 by Bill Eubanks|||
Senjou no Ookami II ~ Mercs||Senjou no Ookami II ~ Mercs||
Sensible Soccer: European Champions: 92/93 Edition|||Sensible Soccer - European Champions - 9293 Edition|
Sensible Soccer: International Edition||Sensible Soccer - International Edition||
Sensible Soccer: International Edition|Sensible Soccer - International Edition|||
Sensible Soccer|Sensible Soccer|Sensible Soccer||
Sesame Street Counting Cafe|Sesame Street Counting Cafe|Sesame Street Counting Cafe||
SGCC Demo 1|SGCC Demo 1|||
SGCC Demo 2|SGCC Demo 2|||
SGCC Demo 3|SGCC Demo 3|||
SGCC Demo 4|SGCC Demo 4|||
SGCC Demo 5|SGCC Demo 5|||
SGCC Demo 6|SGCC Demo 6|||
Shadow Blasters|Shadow Blasters|Shadow Blasters||
Shadow Dancer: The Secret of Shinobi||Shadow Dancer - The Secret of Shinobi||
Shadow Dancer: The Secret of Shinobi|Shadow Dancer - The Secret of Shinobi|||
Shadow-Highlight Test Program #2|Shadow-Highlight Test Program #2|||
Shadow of the Beast 2|Shadow of the Beast 2|||
Shadow of the Beast II||Shadow of the Beast II||
Shadow of the Beast: Mashou no Okite||Shadow of the Beast - Mashou no Okite||
Shadow of the Beast|Shadow of the Beast|Shadow of the Beast||
Shadowrun|Shadowrun|Shadowrun||
Shadow Squadron|Shadow Squadron|||
Shane Warne Cricket|Shane Warne Cricket|Shane Warne Cricket||
Shanghai 2: Dragon's Eye|Shanghai 2 - Dragon's Eye|||
Shanghai II: Dragon's Eye||Shanghai II - Dragon's Eye||
Shaq Fu|Shaq Fu|||
Shaq-Fu||Shaq-Fu||
Shi Jie Zhi Bang Zheng Ba Zhan: World Pro Baseball 94||Shi Jie Zhi Bang Zheng Ba Zhan - World Pro Baseball 94||
Shijou Saidai no Soukoban||Shijou Saidai no Soukoban||
Shikinjoh||Shikinjoh||
Shi Kin Joh|Shi Kin Joh|||
Shin Changsegi: Ragnacenty|Shin Changsegi - Ragnacenty|||
Shining and the Darkness|Shining and the Darkness|Shining and the Darkness||
Shining Force II: Inishie no Fuuin|Shining Force II - Inishie no Fuuin|||
Shining Force II: Koe no Fuuin||Shining Force II - Koe no Fuuin||
Shining Force II|Shining Force II|Shining Force II||
Shining Force: Kamigami no Isan||Shining Force - Kamigami no Isan||
Shining Force|Shining Force|Shining Force||
Shining Force: The Legacy of Great Intention|Shining Force - The Legacy of Great Intention|||
Shining in the Darkness|Shining in the Darkness|Shining in the Darkness||
Shinobi III: Return of the Ninja Master||Shinobi III - Return of the Ninja Master||
Shinobi III: Return of the Ninja Master|Shinobi III - Return of the Ninja Master|||
Shi no Meikyuu: Labyrinth of Death||Shi no Meikyuu - Labyrinth of Death||
Shin Souseiki Ragnacenty||Shin Souseiki Ragnacenty||
Shiten Myooh|Shiten Myooh|||
Shiten Myouou||Shiten Myouou||
Shogi no Hoshi|Shogi no Hoshi|||
Shougi no Hoshi||Shougi no Hoshi||
Shove It! ...The Warehouse Game||Shove It! ...The Warehouse Game||
Shove It!: The Warehouse Game|Shove It! - The Warehouse Game|||
Show do Milhao|Show do Milhao|Show do Milhao||
Show do Milhao Volume 2|Show do Milhao Volume 2|Show do Milhao Volume 2||
Shui Hu: Feng Yun Zhuan||Shui Hu - Feng Yun Zhuan||
Shui Hu Zhuan||Shui Hu Zhuan||
Shura no Mon|Shura no Mon|Shura no Mon||
Side Pocket|Side Pocket|Side Pocket||
Simpsons, The: Bart's Nightmare||Simpsons, The - Bart's Nightmare||
Simpsons, The: Bart's Nightmare|Simpsons, The - Bart's Nightmare|||
Simpsons, The: Bart vs The Space Mutants|Simpsons, The - Bart vs The Space Mutants|||
Simpsons, The: Bart vs. The Space Mutants||Simpsons, The - Bart vs. The Space Mutants||
Singapore I Love You by Fonzie|Singapore I Love You by Fonzie|||
Sink or Swim|||Sink or Swim|
SJIS Text Demo by Uchuusen|SJIS Text Demo by Uchuusen|||
Skeleton Krew|Skeleton Krew|Skeleton Krew||
Skitchin'|Skitchin'|Skitchin'||
Slam Dunk: Shikyou Gekitotsu!|Slam Dunk - Shikyou Gekitotsu!|||
Slap Fight MD||Slap Fight MD||
Slap Fight|Slap Fight|||
Slaughter Sport|Slaughter Sport|Slaughter Sport||
Slime World||Slime World||
Smart Mouse|Smart Mouse|||
Smurfs 2|||Smurfs 2, The|
Snake 3D|||Snake 3D|
Snake Rattle 'n' Roll|Snake Rattle 'n' Roll|||
Snake Rattle n Roll||Snake Rattle n Roll||
Snow Bros.: Nick & Tom||Snow Bros. - Nick & Tom||
Snow Bros.: Nick & Tom|Snow Bros. - Nick & Tom|||
Socket|Socket|Socket||
So Gooooooood by Kaneda|So Gooooooood by Kaneda|||
Sokoban|Sokoban|||
Sol-Deace|Sol-Deace|Sol-Deace||
Soldiers of Fortune|Soldiers of Fortune|Soldiers of Fortune||
Soleil|Soleil|Soleil||
Sonic 1.1 by Rich Rogers|Sonic 1.1 by Rich Rogers|||
Sonic 3D Blast|Sonic 3D Blast|Sonic 3D Blast||
Sonic 3D Blast ~ Sonic 3D Flickies' Island||Sonic 3D Blast ~ Sonic 3D Flickies' Island||
Sonic and Crackers|Sonic and Crackers|||
Sonic and Knuckles & Sonic 1|Sonic and Knuckles & Sonic 1|||
Sonic and Knuckles & Sonic 2|Sonic and Knuckles & Sonic 2|||
Sonic and Knuckles & Sonic 3|Sonic and Knuckles & Sonic 3|||
Sonic and Knuckles|Sonic and Knuckles|||
Sonic Classics Rev 1|||Sonic Classics Rev 01|
Sonic Classics|Sonic Classics|||
Sonic Compilation Rev 00|||Sonic Compilation Rev 00|
Sonic Compilation ~ Sonic Classics (World) ()||Sonic Compilation ~ Sonic Classics (World) ()||
Sonic Compilation||Sonic Compilation||
Sonic Crackers||Sonic Crackers||
Sonic Eraser|Sonic Eraser|Sonic Eraser|Sonic Eraser|
Sonic Jam 6|Sonic Jam 6|||
Sonic & Knuckles||Sonic & Knuckles||
Sonic & Knuckles + Sonic The Hedgehog 2||Sonic & Knuckles + Sonic The Hedgehog 2||
Sonic & Knuckles + Sonic The Hedgehog 3||Sonic & Knuckles + Sonic The Hedgehog 3||
Sonic & Knuckles + Sonic The Hedgehog||Sonic & Knuckles + Sonic The Hedgehog||
Sonic Spinball|Sonic Spinball|Sonic Spinball||
Sonic the Hedgehog 2 Rev 1|||Sonic the Hedgehog 2 Rev 01|
Sonic the Hedgehog 2 Rev 2|||Sonic the Hedgehog 2 Rev 02|
Sonic The Hedgehog 2|Sonic The Hedgehog 2|Sonic The Hedgehog 2|Sonic the Hedgehog 2 Rev 00|
Sonic The Hedgehog 3|Sonic The Hedgehog 3|Sonic The Hedgehog 3||
Sonic the Hedgehog Rev 1|||Sonic the Hedgehog Rev 01|
Sonic The Hedgehog|Sonic The Hedgehog|Sonic The Hedgehog|Sonic the Hedgehog Rev 00|
Sorcerer's Kingdom|Sorcerer's Kingdom|Sorcerer's Kingdom||
Sorcerer's Kingdom (USA) ()||Sorcerer's Kingdom (USA) ()||
Sorcerian|Sorcerian|Sorcerian||
Sorcer Kingdom|Sorcer Kingdom|Sorcer Kingdom||
Soul Blade|Soul Blade|||
Space Funky B.O.B.|Space Funky B.O.B.|Space Funky B.O.B.||
Space Harrier II|Space Harrier II|Space Harrier II||
Space Harrier|Space Harrier|||
Space Invaders 90|Space Invaders 90|Space Invaders 90||
Space Invaders '91||Space Invaders '91||
Space Invaders 91|Space Invaders 91|||
Spacewar V0.00|Spacewar V0.00|||
Spacewar V0.01|Spacewar V0.01|||
Sparkster: Rocket Knight Adventures 2||Sparkster - Rocket Knight Adventures 2||
Sparkster|Sparkster|Sparkster||
Speedball 2: Brutal Deluxe||Speedball 2 - Brutal Deluxe||
Speed Ball 2: Brutal Deluxe|Speed Ball 2 - Brutal Deluxe|||
Speedball 2||Speedball 2||
Spheres|Spheres|||
Spider-Man and Venom: Maximum Carnage|Spider-Man and Venom - Maximum Carnage|||
Spider-Man and Venom: Separation Anxiety|Spider-Man and Venom - Separation Anxiety|||
Spider-Man and X-Men: Arcade's Revenge||Spider-Man and X-Men - Arcade's Revenge||
Spider-Man and X-Men: Arcade's Revenge|Spider-Man and X-Men - Arcade's Revenge|||
Spider-Man||Spider-Man||
Spider-Man: The Animated Series|Spider-Man - The Animated Series|||
Spider-Man . Venom: Maximum Carnage||Spider-Man . Venom - Maximum Carnage||
Spider-Man vs The Kingpin|Spider-Man vs The Kingpin|||
Spider-Man vs The Kingpin|Spider-Man vs The Kingpin||Spider-Man vs. The Kingpin|
Spider-Man: Web of Fire|Spider-Man - Web of Fire|||
Spiritual Warfare|Spiritual Warfare|Spiritual Warfare||
Spirou|Spirou|Spirou||
Splatterhouse 2|Splatterhouse 2|Splatterhouse 2||
Splatterhouse 3|Splatterhouse 3|Splatterhouse 3||
Splatterhouse Part 2||Splatterhouse Part 2||
Splatterhouse Part 3|Splatterhouse Part 3|Splatterhouse Part 3||
Sport Games|Sport Games|Sport Games||
Sports Talk Baseball||Sports Talk Baseball||
Spot Goes to Hollywood|Spot Goes to Hollywood|Spot Goes to Hollywood||
Squirrel King|Squirrel King|Squirrel King||
Star Control|Star Control|Star Control||
Star Cruiser|Star Cruiser|Star Cruiser||
Starflight|Starflight|Starflight||
Starflight (USA, Europe) ()||Starflight (USA, Europe) ()||
Stargate|Stargate|Stargate||
Star Trek: Deep Space 9: Crossroads of Time|Star Trek - Deep Space 9 - Crossroads of Time|||
Star Trek: Deep Space Nine: Crossroads of Time||Star Trek - Deep Space Nine - Crossroads of Time||
Star Trek: Starfleet Academy Bridge Simulator|Star Trek - Starfleet Academy Bridge Simulator|||
Star Trek: The Next Generation: Echoes from the Past||Star Trek - The Next Generation - Echoes from the Past||
Star Trek: The Next Generation: Echoes from the Past (USA) ()||Star Trek - The Next Generation - Echoes from the Past (USA) ()||
Star Trek: The Next Generation|Star Trek - The Next Generation|||
Star Wars Arcade|Star Wars Arcade|||
ST Dream by Kaneda|ST Dream by Kaneda|||
Steel Empire||Steel Empire||
Steel Talons|Steel Talons|Steel Talons||
Stone Protectors||Stone Protectors||
Stormlord|Stormlord|Stormlord||
Story of Thor, The: A Successor of The Light|||Story of Thor, The - A Successor of The Light|
Story of Thor, The: A Successor of The Light|Story of Thor, The - A Successor of The Light|||
Story of Thor, The: Hikari o Tsugumono||Story of Thor, The - Hikari o Tsugumono||
Street Fighter II' Plus Champion Edition||Street Fighter II' Plus Champion Edition||
Street Fighter II' Plus: Champion Edition|Street Fighter II' Plus - Champion Edition|||
Street Fighter II': Special Champion Edition||Street Fighter II' - Special Champion Edition||
Street Fighter II': Special Champion Edition|Street Fighter II' - Special Champion Edition|||
Street Fighter II' Turbo|Street Fighter II' Turbo|||
Street Fucker|Street Fucker|||
Street Racer|Street Racer|Street Racer||
Street Smart|Street Smart|Street Smart||
Streets of Rage 2|Streets of Rage 2|Streets of Rage 2|Streets of Rage 2|
Streets of Rage 3: Special Edition|Streets of Rage 3 - Special Edition|||
Streets of Rage 3|Streets of Rage 3|Streets of Rage 3|Streets of Rage 3|
Streets of Rage|Streets of Rage|||
Strider Hiryuu|Strider Hiryuu|Strider Hiryuu||
Strider II|Strider II|Strider II||
Strider Returns: Journey from Darkness||Strider Returns - Journey from Darkness||
Strider|Strider|Strider||
Striker|Striker|Striker||
Sub-Terrania|Sub-Terrania|Sub-Terrania||
Summer Challenge|Summer Challenge|Summer Challenge||
Summer Demo 2004 by Fonzie|Summer Demo 2004 by Fonzie|||
Sunset Riders|Sunset Riders|Sunset Riders||
Super 15-in-1|Super 15-in-1|||
Super 19-in-1|Super 19-in-1|||
Super Airwolf|Super Airwolf|Super Airwolf||
Super Baseball 2020|Super Baseball 2020|Super Baseball 2020||
Super Battleship|Super Battleship|Super Battleship||
Super Battle Tank: War in the Gulf|Super Battle Tank - War in the Gulf|||
Super Bubble Bobble|Super Bubble Bobble|Super Bubble Bobble||
Super Caesar's Palace|Caesars Palace|Caesars Palace||
Super Daisenryaku|Super Daisenryaku|Super Daisenryaku||
Super Donkey Kong 99|Super Donkey Kong 99|||
Super Fantasy Zone|Super Fantasy Zone|Super Fantasy Zone||
Super-Fly Game Engine by Uchuusen|Super-Fly Game Engine by Uchuusen|||
Super Hang-On|Super Hang-On|Super Hang-On||
Super High Impact|Super High Impact|Super High Impact||
Super H.Q.||Super H.Q.||
Super HQ|Super HQ|||
Super Hydlide|Super Hydlide|Super Hydlide||
Super Kick Off|Super Kick Off|Super Kick Off||
Super King Kong 99|Super King Kong 99|||
Super League 91|Super League 91|||
Super League|Super League|Super League||
Superman|Superman|Superman||
Superman: The Man of Steel||Superman - The Man of Steel||
Super Mario 2 1998|Super Mario 2 1998|||
Super Mario Bros.|Super Mario Bros.|||
Super Mario World|Super Mario World|||
Super Masters Golf|Super Masters Golf|||
Super Monaco GP||Super Monaco GP||
Super Monaco Grand Prix|Super Monaco Grand Prix|||
Super Off Road|Super Off Road|Super Off Road||
Super Ping Pong|Super Ping Pong|||
Super Real Basketball|Super Real Basketball|Super Real Basketball||
Super Skidmarks|Super Skidmarks|Super Skidmarks||
Super Smash TV|Super Smash TV|||
Super Smash T.V.||Super Smash T.V.|Smash T.V.|
Super Street Fighter II - The New Challengers||Super Street Fighter II - The New Challengers||
Super Street Fighter II - The New Challengers|Super Street Fighter II - The New Challengers|||
Super Thunder Blade|Super Thunder Blade|Super Thunder Blade||
Super Volleyball|Super Volleyball|||
Super Volley Ball||Super Volley Ball||
Super-X Engine Test V0.3 by Fonzie|Super-X Engine Test V0.3 by Fonzie|||
Super-X Raycasting Engine Test 1 by Fonzie|Super-X Raycasting Engine Test 1 by Fonzie|||
Super-X Raycasting Engine Test 2 by Fonzie|Super-X Raycasting Engine Test 2 by Fonzie|||
Surging Aura|Surging Aura|Surging Aura||
Swamp Thing||Swamp Thing||
Switching CRAM Palettes by DevSter|Switching CRAM Palettes by DevSter|||
Sword of Sodan|Sword of Sodan|Sword of Sodan||
Sword of Vermilion|Sword of Vermilion|Sword of Vermilion||
Syd of Valis|Syd of Valis|Syd of Valis|SD Valis|
Sylvester and Tweety in Cagey Capers||Sylvester and Tweety in Cagey Capers||
Sylvester & Tweety in Cagey Capers|Sylvester & Tweety in Cagey Capers|Sylvester & Tweety in Cagey Capers||
Syndicate|Syndicate|Syndicate||
T2: Terminator 2: Judgment Day||T2 - Terminator 2 - Judgment Day||
T2: The Arcade Game||T2 - The Arcade Game||
T2: The Arcade Game|T2 - The Arcade Game|||
Taiga Drama Taiheiki|Taiga Drama Taiheiki|||
Taikou Risshiden|Taikou Risshiden|Taikou Risshiden||
Taiwan Daheng||Taiwan Daheng||
Taiwan Tycoon|Taiwan Tycoon|||
Tale Spin|Tale Spin|||
TaleSpin||TaleSpin||
Talmit's Adventure|Talmit's Adventure|Talmit's Adventure||
Tanto R|Tanto R|||
Target Earth|Target Earth|Target Earth||
Task Force Harrier EX|Task Force Harrier EX|Task Force Harrier EX||
Tatsujin ~ Truxton||Tatsujin ~ Truxton||
Tavern RPG Alpha V1.0 by Fonzie|Tavern RPG Alpha V1.0 by Fonzie|||
Tavern RPG Alpha V1.1 by Fonzie|Tavern RPG Alpha V1.1 by Fonzie|||
Tavern RPG InGame Alpha V0.1 by Fonzie|Tavern RPG InGame Alpha V0.1 by Fonzie|||
Tavern RPG InGame Alpha V0.2 by Fonzie|Tavern RPG InGame Alpha V0.2 by Fonzie|||
Tavern RPG InGame Alpha V0.3 by Fonzie|Tavern RPG InGame Alpha V0.3 by Fonzie|||
Tavern RPG InGame Alpha V0.4 by Fonzie|Tavern RPG InGame Alpha V0.4 by Fonzie|||
Tavern RPG InGame Alpha V0.5.1 by Fonzie|Tavern RPG InGame Alpha V0.5.1 by Fonzie|||
Tavern RPG InGame Alpha V0.5.2 by Fonzie|Tavern RPG InGame Alpha V0.5.2 by Fonzie|||
Taz in Escape from Mars|Escape From Mars Starring Taz|||
Taz in Escape from Mars||Taz in Escape from Mars||
Taz-Mania|Taz-Mania|Taz-Mania||
Team USA Basketball|Team USA Basketball|Team USA Basketball||
Technical Demo by Fonzie|Technical Demo by Fonzie|||
Techno Clash|Techno Clash|Techno Clash||
Technocop|Technocop|Technocop||
Tecmo Cup|Tecmo Cup|Tecmo Cup||
Tecmo Super Baseball|Tecmo Super Baseball|Tecmo Super Baseball||
Tecmo Super Bowl III Final Edition|Tecmo Super Bowl III Final Edition|||
Tecmo Super Bowl III: Final Edition||Tecmo Super Bowl III - Final Edition||
Tecmo Super Bowl II SE|Tecmo Super Bowl II SE|||
Tecmo Super Bowl II: Special Edition||Tecmo Super Bowl II - Special Edition||
Tecmo Super Bowl|Tecmo Super Bowl|Tecmo Super Bowl||
Tecmo Super Hockey|Tecmo Super Hockey|Tecmo Super Hockey||
Tecmo Super NBA Basketball|Tecmo Super NBA Basketball|Tecmo Super NBA Basketball||
Tecmo World Cup '92|Tecmo World Cup '92|Tecmo World Cup '92||
Tecmo World Cup '93|Tecmo World Cup '93|||
Tecmo World Cup||Tecmo World Cup||
Teddy Boy Blues||Teddy Boy Blues||
Teenage Mutant Hero Turtles: The Hyperstone Heist||Teenage Mutant Hero Turtles - The Hyperstone Heist||
Teenage Mutant Hero Turtles: The Hyperstone Heist|Teenage Mutant Hero Turtles - The Hyperstone Heist|||
Teenage Mutant Hero Turtles: Tournament Fighters||Teenage Mutant Hero Turtles - Tournament Fighters||
Teenage Mutant Hero Turtles: Tournament Fighters|Teenage Mutant Hero Turtles - Tournament Fighters|||
Teenage Mutant Ninja Turtles: Return of the Shredder||Teenage Mutant Ninja Turtles - Return of the Shredder||
Teenage Mutant Ninja Turtles: Return of the Shredder|Teenage Mutant Ninja Turtles - Return of the Shredder|||
Teenage Mutant Ninja Turtles: The Hyperstone Heist||Teenage Mutant Ninja Turtles - The Hyperstone Heist||
Teenage Mutant Ninja Turtles: The Hyperstone Heist|Teenage Mutant Ninja Turtles - The Hyperstone Heist|||
Teenage Mutant Ninja Turtles: Tournament Fighters||Teenage Mutant Ninja Turtles - Tournament Fighters||
Teenage Mutant Ninja Turtles: Tournament Fighters|Teenage Mutant Ninja Turtles - Tournament Fighters|||
Teitoku no Ketsudan|Teitoku no Ketsudan|Teitoku no Ketsudan||
Tekken 3 Special|Tekken 3 Special|||
Telebradesco Residencia|Telebradesco Residencia|Telebradesco Residencia||
Tel Tel Mahjong|Tel Tel Mahjong|||
Tel-Tel Mahjong||Tel-Tel Mahjong||
Tel Tel Stadium|Tel Tel Stadium|||
Tel-Tel Stadium||Tel-Tel Stadium||
Tempo|Tempo|||
Terminator 2 - Judgment Day|Terminator 2 - Judgment Day|||
Test Drive II: The Duel||Test Drive II - The Duel||
Test Drive II: The Duel|Test Drive II - The Duel|||
Tetman|||Tetman|
Tetris|Tetris|Tetris||
The Addams Family|Addams Family, The|Addams Family, The|Addams Family, The|
The Adventures of Batman and Robin|Adventures of Batman and Robin, The|||
The Adventures of Batman & Robin|Adventures of Batman and Robin, The|Adventures of Batman & Robin, The|Adventures of Batman & Robin, The|
The Adventures of Batman & Robin||Adventures of Batman & Robin, The||
The Adventures of Mighty Max||Adventures of Mighty Max, The||
The Adventures of Mighty Max|Adventures of Mighty Max, The|||
The Adventures of Mighty Max|Adventures of Mighty Max, The|Adventures of Mighty Max, The||
The Adventures of Rocky and Bullwinkle and Friends||Adventures of Rocky and Bullwinkle and Friends, The||
The Adventures of Rocky and Bullwinkle and Friends||Adventures of Rocky and Bullwinkle and Friends, The|Adventures of Rocky and Bullwinkle and Friends, The|
The Aquatic Games Starring James Pond and the Aquabats||Aquatic Games Starring James Pond and the Aquabats, The||
The Aquatic Games: Starring James Pond and the Aquabats|Aquatic Games - Starring James Pond, The|||
The Aquatic Games: Starring James Pond|Aquatic Games - Starring James Pond, The|||
The Berenstain Bears' Camping Adventure||Berenstain Bears' Camping Adventure, The||
The Berenstain Bears' Camping Adventure|Berenstain Bears', The - Camping Adventure|Berenstain Bears' Camping Adventure, The||
The Chaos Engine 2||Chaos Engine 2, The||
The Chaos Engine||Chaos Engine, The||
The Chaos Engine|Chaos Engine, The|||
The Daze Before Christmas|Daze Before Christmas, The|||
The Death and Return of Superman||Death and Return of Superman, The||
The Death and Return of Superman|Death and Return of Superman, The|||
The Death and Return of Superman|Death and Return of Superman, The|Death and Return of Superman, The||
The Disney Collection||Disney Collection, The||
The Duel: Test Drive II|Test Drive II - The Duel|Test Drive II - The Duel|Duel, The - Test Drive II|
The Earth Defend|Earth Defend, The|||
The Earth Defend|Earth Defend, The||Earth Defend, The|
The Faery Tale Adventure||Faery Tale Adventure, The||
The Faery Tale Adventure|Faery Tale Adventure, The|||
The Flintstones||Flintstones, The||
The Flintstones|Flintstones, The|||
The Gadget Twins|Gadget Twins, The|||
The Great Circus Mystery Starring Mickey & Minnie||Great Circus Mystery Starring Mickey & Minnie, The||
The Great Waldo Search||Great Waldo Search, The||
The Great Waldo Search|Great Waldo Search, The|||
The Humans||Humans, The||
The Humans|Humans, The|||
The Hybrid Front||Hybrid Front, The||
The Hybrid Front|Hybrid Front, The|||
The Immortal||Immortal, The||
The Immortal|Immortal, The|||
The Incredible Crash Dummies||Incredible Crash Dummies, The||
The Incredible Crash Dummies|Incredible Crash Dummies, The|||
The Incredible Hulk||Incredible Hulk, The||
The Incredible Hulk|Incredible Hulk, The|||
The Itchy and Scratchy Game||Itchy and Scratchy Game, The||
The Itchy and Scratchy Game|Itchy and Scratchy Game, The|||
The Jungle Book||Jungle Book, The||
The Jungle Book|Jungle Book, The|||
The Kick Boxing||Kick Boxing, The||
The Kick Boxing|Kick Boxing, The|||
The Killing Game Show||Killing Game Show, The||
The Killing Game Show|Killing Game Show, The|||
The King of Fighters '98|King of Fighters '98, The|||
The Lawnmower Man||Lawnmower Man, The||
The Lawnmower Man|Lawnmower Man, The|||
The Legend of Galahad||Legend of Galahad, The||
The Legend of Galahad|Legend of Galahad, The|||
The Lion King II|Lion King II, The|||
The Lion King||Lion King, The||
The Lion King|Lion King, The|||
The Lost Vikings||Lost Vikings, The||
The Lost Vikings|Lost Vikings, The|||
The Magic School Bus||Magic School Bus, The||
The Magic School Bus|Magic School Bus, The|||
Theme Park|Theme Park|Theme Park||
The Miracle Piano Teaching System||Miracle Piano Teaching System, The||
The Misadventures of Flink|Misadventures of Flink, The|||
The New Zealand Story||New Zealand Story, The||
The New Zealand Story|New Zealand Story, The|||
The Ooze||Ooze, The||
The Ooze|Ooze, The|||
The Ottifants||Ottifants, The||
The Ottifants|Ottifants, The|||
The Pagemaster||Pagemaster, The||
The Pagemaster|Pagemaster, The|||
The Pirates of Dark Water||Pirates of Dark Water, The||
The Pirates of Dark Water|Pirates of Dark Water, The|||
The Ren & Stimpy Show Presents Stimpy's Invention||Ren & Stimpy Show Presents Stimpy's Invention, The||
The Second Samurai|Second Samurai, The|||
The Smurfs 2|Smurfs 2, The|||
The Smurfs||Smurfs, The||
The Smurfs|Smurfs, The|||
The Smurfs Travel the World||Smurfs Travel the World, The||
The Steel Empire|Steel Empire, The|||
The Story of Thor||Story of Thor, The||
The Super Shinobi II||Super Shinobi II, The||
The Super Shinobi II|Super Shinobi II, The|||
The Super Shinobi||Super Shinobi, The||
The Terminator||Terminator, The||
The Terminator|Terminator, The|||
The Tick||Tick, The||
The Tick|Tick, The|||
The Yang Warrior Family|Yang Warrior Family, The|||
The Young Indiana Jones Chronicles||Young Indiana Jones Chronicles, The||
Thomas the Tank Engine & Friends|Thomas the Tank Engine & Friends|Thomas the Tank Engine & Friends||
Thunder Force III|Thunder Force III|Thunder Force III||
Thunder Force II MD|Thunder Force II MD|Thunder Force II MD||
Thunder Force II|Thunder Force II|Thunder Force II||
Thunder Force IV|Thunder Force IV|Thunder Force IV||
Thunder Fox|Thunder Fox|Thunder Fox||
Thunder Pro Wrestling Retsuden||Thunder Pro Wrestling Retsuden||
Tiger Hunter Hero Novel|Tiger Hunter Hero Novel|||
Tiles Loader V1.0 by Fonzie|Tiles Loader V1.0 by Fonzie|||
Time Dominator 1st|Time Dominator 1st|Time Dominator 1st||
Time Invaders|||Time Invaders|
Time Killers|Time Killers|Time Killers||
Tinhead|Tinhead|||
TinHead||TinHead||
Tintin au Tibet||Tintin au Tibet||
Tintin Au Tibet|Tintin Au Tibet|||
Tiny Toon Adventures: Acme All-Stars||Tiny Toon Adventures - Acme All-Stars||
Tiny Toon Adventures: Acme All-Stars|Tiny Toon Adventures - Acme All-Stars|||
Tiny Toon Adventures: Buster's Hidden Treasure||Tiny Toon Adventures - Buster's Hidden Treasure||
Tiny Toon Adventures: Buster's Hidden Treasure|Tiny Toon Adventures - Buster's Hidden Treasure|||
Tiny Toon Adventures||Tiny Toon Adventures||
T-MEK|T-MEK|||
TNN Bass Tournament of Champions|TNN Bass Tournament of Champions|TNN Bass Tournament of Champions||
TNN Outdoors Bass Tournament '96|TNN Outdoors Bass Tournament '96|TNN Outdoors Bass Tournament '96||
Todd's Adventures in Slime World|Todd's Adventures in Slime World|Todd's Adventures in Slime World||
ToeJam & Earl in Panic auf Funkotron||ToeJam & Earl in Panic auf Funkotron||
Toejam & Earl in Panic on Funkotron|Toejam & Earl in Panic on Funkotron|||
ToeJam & Earl in Panic on Funkotron||ToeJam & Earl in Panic on Funkotron||
Toejam & Earl|Toejam & Earl|||
ToeJam & Earl||ToeJam & Earl||
Togepi!|Togepi!|||
Toki: Going Ape Spit|Toki - Going Ape Spit|||
Tom and Jerry: Frantic Antics||Tom and Jerry - Frantic Antics||
Tom and Jerry: Frantic Antics|Tom and Jerry - Frantic Antics|||
Tommy Lasorda Baseball|Tommy Lasorda Baseball|Tommy Lasorda Baseball||
Tom's X-Mas Demo 2004 by Tom Maneiro|Tom's X-Mas Demo 2004 by Tom Maneiro|||
Tongue of the Fatman|||Tongue of the Fatman|
Tony La Russa Baseball 95|Tony La Russa Baseball 95|||
Tony La Russa Baseball|Tony La Russa Baseball|Tony La Russa Baseball||
Top Fighter 2000 MK VIII|Top Fighter 2000 MK VIII|||
Top Gear 2|Top Gear 2|Top Gear 2||
Top Pro Golf 2|Top Pro Golf 2|Top Pro Golf 2||
Top Pro Golf|Top Pro Golf|Top Pro Golf||
Top Shooter|Top Shooter|||
Total Football|Total Football|Total Football||
TotoTek Multi-Game Menu V1.00|TotoTek Multi-Game Menu V1.00|||
Toughman Contest|Toughman Contest|Toughman Contest||
Tougiou King Colossus||Tougiou King Colossus||
Toxic Crusaders|Toxic Crusaders|Toxic Crusaders||
Toys|Toys|Toys||
Trampoline Terror!|Trampoline Terror!|Trampoline Terror!||
Traysia|Traysia|Traysia||
Triple Play '96|Triple Play '96|||
Triple Play 96||Triple Play 96||
Triple Play: Gold Edition||Triple Play - Gold Edition||
Triple Play Gold|Triple Play Gold|||
Triple Score: 3 Games In One|||Triple Score - 3 Games In One|
Trouble Shooter|Trouble Shooter|Trouble Shooter||
Troy Aikman NFL Football|Troy Aikman NFL Football|Troy Aikman NFL Football||
True Lies|True Lies|True Lies||
Truxton|Truxton|||
Tun Shi Tian Di III||Tun Shi Tian Di III||
Turbo Outrun|Turbo Outrun|||
Turbo OutRun||Turbo OutRun||
Turma da Monica na Terra dos Monstros||Turma da Monica na Terra dos Monstros||
Turma da Monica na Terra Dos Monstros|Turma da Monica na Terra Dos Monstros|||
Turrican 3|||Turrican 3|
Turrican|Turrican|Turrican||
Twin Cobra: Desert Attack Helicopter||Twin Cobra - Desert Attack Helicopter||
Twin Cobra|Twin Cobra|||
Twin Hawk|Twin Hawk|||
Twin Hawk|Twin Hawk|Daisenpuu ~ Twin Hawk|Twin Hawk|
Twinkle Tale|Twinkle Tale|Twinkle Tale||
Twisted Flipper|Twisted Flipper|Twisted Flipper||
Two Crude Dudes|Two Crude Dudes|Two Crude Dudes||
Two Tribes: Populous II||Two Tribes - Populous II||
Tyrants: Fight through Time||Tyrants - Fight through Time||
Tyrants: Fight Through Time|Tyrants - Fight Through Time|||
Uchu Senkan Gomora|Uchu Senkan Gomora|||
Uchuu Senkan Gomora||Uchuu Senkan Gomora||
Ultimate Mortal Kombat 3|Ultimate Mortal Kombat 3|Ultimate Mortal Kombat 3||
Ultimate Qix|Ultimate Qix|Ultimate Qix||
Ultimate Soccer|Ultimate Soccer|Ultimate Soccer||
Ultimate Tetris by Haroldo de Oliveira Pinheiro|Ultimate Tetris by Haroldo de Oliveira Pinheiro|||
Ultraman|Ultraman|Ultraman||
Uncharted Waters: New Horizons|Uncharted Waters - New Horizons|||
Uncharted Waters|Uncharted Waters|Uncharted Waters||
Undead Line|Undead Line|Undead Line||
Universal Driver Demo V4.0|Universal Driver Demo V4.0|||
Universal Soldier|Universal Soldier|Universal Soldier||
Unknown Chinese Game 1|Unknown Chinese Game 1|||
Unknown Chinese Game 2|Unknown Chinese Game 2|||
Unnecessary Roughness '95||Unnecessary Roughness '95||
Unnecessary Roughness 95|Unnecessary Roughness 95|||
Urban Strike|Urban Strike|Urban Strike||
Uzu Keobukseon|Uzu Keobukseon|Uzu Keobukseon||
Valis 3|||Valis III|
Valis III|Valis III|Valis III||
Valis SD|Valis SD|||
Valis: The Fantasm Soldier|||Valis - Fantasm Soldier, The|
Valis|Valis|Valis||
Vampire Killer|Vampire Killer|Vampire Killer||
Vapor Trail|Vapor Trail|Vapor Trail||
Vectorman 2|Vectorman 2|Vectorman 2||
Vectorman|Vectorman|Vectorman||
Vehicle Minigame by Johnny13|Vehicle Minigame by Johnny13|||
Venom . Spider-Man: Separation Anxiety||Venom . Spider-Man - Separation Anxiety||
Vermilion||Vermilion||
Very Simple FM Music Player by Uchuusen|Very Simple FM Music Player by Uchuusen|||
Verytex|Verytex|Verytex||
V-Five|V-Five|||
Viewpoint|Viewpoint|Viewpoint||
Virtua Fighter 2|Virtua Fighter 2|Virtua Fighter 2||
Virtua Fighter 2 vs Tekken 2|Virtua Fighter 2 vs Tekken 2|||
Virtua Fighter|Virtua Fighter|||
Virtual Bart|Virtual Bart|Virtual Bart||
Virtual Pinball|Virtual Pinball|Virtual Pinball||
Virtua Racing Deluxe|Virtua Racing Deluxe|||
Virtua Racing|Virtua Racing|Virtua Racing||
Visual Novel Game System Demo by Uchuusen|Visual Novel Game System Demo by Uchuusen|||
Vixen 357|Vixen 357|Vixen 357||
Volfied|Volfied|Volfied||
VR Troopers|VR Troopers|VR Troopers||
V-V||V-V||
Wacky Races|Wacky Races|Wacky Races||
Wacky Worlds Creativity Studio||Wacky Worlds Creativity Studio||
Wacky Worlds|Wacky Worlds|||
Waialae no Kiseki|Waialae no Kiseki|||
Wang-Yu-Yen Fighter Demo|Wang-Yu-Yen Fighter Demo|||
Wani Wani World|Wani Wani World|Wani Wani World||
Wardner no Mori Special|Wardner no Mori Special|Wardner no Mori Special||
Wardner|Wardner|Wardner||
Warlock|Warlock|Warlock||
Warpspeed|Warpspeed|||
WarpSpeed||WarpSpeed||
Warrior of Rome II|Warrior of Rome II|Warrior of Rome II||
Warrior of Rome|Warrior of Rome|Warrior of Rome||
Warsong|Warsong|Warsong||
Waterworld|Waterworld|Waterworld||
Wayne Gretzky and the NHLPA All-Stars||Wayne Gretzky and the NHLPA All-Stars||
Wayne Gretzsky NHLPA All-Stars|Wayne Gretzsky NHLPA All-Stars|||
Wayne's World|Wayne's World|Wayne's World||
Weaponlord|Weaponlord|||
WeaponLord||WeaponLord||
We're Back!: A Dinosaur's Tale|We're Back! - A Dinosaur's Tale|||
Whac-a-Critter||Whac-a-Critter||
Whac-A-Critter|Whac-A-Critter|||
Wheel of Fortune|Wheel of Fortune|Wheel of Fortune||
Where in the World is Carmen Sandiego|Where in the World is Carmen Sandiego|||
Where in the World Is Carmen Sandiego||Where in the World Is Carmen Sandiego||
Where in Time is Carmen Sandiego|Where in Time is Carmen Sandiego|||
Where in Time Is Carmen Sandiego||Where in Time Is Carmen Sandiego||
Whip Rush 2222 AD|Whip Rush 2222 AD|||
Whip Rush: Wakusei Voltegas no Nazo||Whip Rush - Wakusei Voltegas no Nazo||
Whip Rush||Whip Rush||
Wild Snake|Wild Snake|Wild Snake||
Williams Arcade's Greatest Hits|Williams Arcade's Greatest Hits|Williams Arcade's Greatest Hits||
Wimbledon Championship Tennis|Wimbledon Championship Tennis|Wimbledon Championship Tennis||
Windows 68K Edition Setup V1.08.1215 by Tom Maneiro|Windows 68K Edition Setup V1.08.1215 by Tom Maneiro|||
Window Test by Fonzie|Window Test by Fonzie|||
Wings of Wor|Wings of Wor|Wings of Wor||
Winter Challenge|Winter Challenge|Winter Challenge||
Winter Olympic Games||Winter Olympic Games||
Winter Olympics||Winter Olympics||
Wizard of the Immortal||Wizard of the Immortal||
Wiz 'n' Liz: The Frantic Wabbit Wescue|Wiz 'n' Liz - The Frantic Wabbit Wescue|||
Wiz'n'Liz: The Frantic Wabbit Wescue||Wiz'n'Liz - The Frantic Wabbit Wescue||
Wiz'n'Liz||Wiz'n'Liz||
Wolfchild||Wolfchild||
Wolf Child|Wolf Child|||
Wolverine Adamantium Rage|Wolverine Adamantium Rage|||
Wolverine: Adamantium Rage||Wolverine - Adamantium Rage||
Wonder Boy III - Monster Lair|Wonder Boy III - Monster Lair|Wonder Boy III - Monster Lair||
Wonder Boy in Monster World|Wonder Boy in Monster World|Wonder Boy in Monster World||
Wonder Boy V: Monster World III||Wonder Boy V - Monster World III||
Wonder Boy V: Monster World III|Wonder Boy V - Monster World III|||
Wonder Library|Wonder Library|Wonder Library||
World Championship Soccer II|World Championship Soccer II|World Championship Soccer II||
World Championship Soccer|World Championship Soccer|||
World Class Leaderboard Golf|World Class Leaderboard Golf|World Class Leaderboard Golf||
World Cup Italia '90||World Cup Italia '90||
World Cup Italia 90|World Cup Italia 90|||
World Cup Soccer ~ World Championship Soccer (Japan, USA) ()||World Cup Soccer ~ World Championship Soccer (Japan, USA) ()||
World Cup Soccer ~ World Championship Soccer||World Cup Soccer ~ World Championship Soccer||
World Cup USA 94|World Cup USA 94|World Cup USA 94||
World Heroes|World Heroes|World Heroes||
World of Illusion: Fushigi na Magic Box||World of Illusion - Fushigi na Magic Box||
World of Illusion Starring Mickey Mouse and Donald Duck||World of Illusion Starring Mickey Mouse and Donald Duck||
World of Illusion Starring Mickey Mouse & Donald Duck|World of Illusion Starring Mickey Mouse & Donald Duck|||
World Pro Baseball 94|World Pro Baseball 94|||
World Series Baseball '95|World Series Baseball '95|World Series Baseball '95||
World Series Baseball '96|World Series Baseball '96|World Series Baseball '96||
World Series Baseball '98|World Series Baseball '98|||
World Series Baseball 98||World Series Baseball 98||
World Series Baseball|World Series Baseball|World Series Baseball||
World Trophy Soccer|World Trophy Soccer|World Trophy Soccer||
Worms|Worms|Worms||
Wrestleball|Wrestleball|Wrestleball||
Wrestle War|Wrestle War|Wrestle War||
Wu Kong Wai Zhuan||Wu Kong Wai Zhuan||
WWF Raw||WWF Raw||
WWF RAW|WWF RAW|||
WWF Royal Rumble|WWF Royal Rumble|WWF Royal Rumble||
WWF Super Wrestlemania|WWF Super Wrestlemania|||
WWF Super WrestleMania||WWF Super WrestleMania||
WWF Wrestlemania Arcade|WWF Wrestlemania Arcade|||
WWF WrestleMania: The Arcade Game||WWF WrestleMania - The Arcade Game||
X-Band Modem BIOS: Game Toshokan|X-Band Modem BIOS - Game Toshokan|||
X Dazedly Ray|X Dazedly Ray|||
XDR: X-Dazedly-Ray||XDR - X-Dazedly-Ray||
Xenon 2: Megablast||Xenon 2 - Megablast||
Xenon 2: Megablast|Xenon 2 - Megablast|||
Xiao Monv: Magic Girl||Xiao Monv - Magic Girl||
Xin Qi Gai Wang Zi|Xin Qi Gai Wang Zi|Xin Qi Gai Wang Zi||
X-Men 2: Clone Wars||X-Men 2 - Clone Wars||
X-Men 2: Clone Wars|X-Men 2 - Clone Wars|||
X-Men|X-Men|X-Men||
XOR Palette Demo by DevSter|XOR Palette Demo by DevSter|||
X-perts|X-perts|||
X-Perts||X-Perts||
XZR|XZR|||
Yang Jia Jiang: Yang Warrior Family||Yang Jia Jiang - Yang Warrior Family||
Ya Se Chuan Shuo||Ya Se Chuan Shuo||
Ya-Se Chuan Shuo|Ya-Se Chuan Shuo|||
Yase Zhuanshuo|||Yase Zhuanshuo|
YM2612 Editor by K. Banks|YM2612 Editor by K. Banks|||
Yogi Bear: Cartoon Capers||Yogi Bear - Cartoon Capers||
Yogi Bear's Cartoon Capers|Yogi Bear's Cartoon Capers|||
Young Indiana Jones Chronicles|Young Indiana Jones Chronicles|||
Young Indiana Jones: Instrument of Chaos|Young Indiana Jones - Instrument of Chaos|||
Ys III: Wanderers from Ys|Ys III - Wanderers from Ys|||
Ys III: Wanderers from Ys|||Ys - Wanderers from Ys|
Ys III||Ys III||
Ys: Wanderers from Ys||Ys - Wanderers from Ys||
Yuu Yuu Hakusho Gaiden|Yuu Yuu Hakusho Gaiden|||
Yuu Yuu Hakusho: Makyou Toitsusen|Yuu Yuu Hakusho - Makyou Toitsusen|||
Yuu Yuu Hakusho: Sunset Fighters|Yuu Yuu Hakusho - Sunset Fighters|||
Yū Yū Hakusho Gaiden|Yuu Yuu Hakusho Gaiden|Yu Yu Hakusho Gaiden|Yuu Yuu Hakusho Gaiden|
Yū Yū Hakusho: Makyō Tōitsusen|Yuu Yuu Hakusho - Makyou Toitsusen|Yu Yu Hakusho - Makyou Toitsusen|Yuu Yuu Hakusho - Makyou Toitsusen|
Yu Yu Hakusho: Makyou Toitsusen||Yu Yu Hakusho - Makyou Toitsusen||
YuYu Hakusho: Sunset Fighters||YuYu Hakusho - Sunset Fighters||
Zan Yasha Enbuden|Zan Yasha Enbuden|||
Zan Yasha Enbukyoku||Zan Yasha Enbukyoku||
Zan: Yasha Enbukyoku|||Zan - Yasha Enbukyoku|
Zany Golf (USA, Europe) ()||Zany Golf (USA, Europe) ()||
Zany Golf|Zany Golf|Zany Golf||
Zaxxon's Motherbase 2000|Zaxxon's Motherbase 2000|||
Zero the Kamikaze Squirrel|Zero the Kamikaze Squirrel|Zero the Kamikaze Squirrel||
Zero Tolerance|Zero Tolerance|Zero Tolerance||
Zero Wing|Zero Wing|Zero Wing||
Zhuo Gui Da Shi: Ghost Hunter||Zhuo Gui Da Shi - Ghost Hunter||
Zombie High|Zombie High|Zombie High||
Zombies Ate My Neighbors|Zombies Ate My Neighbors|Zombies Ate My Neighbors|Zombies Ate My Neighbors|
Zombies|Zombies|Zombies||
Zool: Ninja of the 'Nth' Dimension||Zool - Ninja of the 'Nth' Dimension||
Zool|Zool|||
Zoom!|Zoom!|Zoom!||
Zoop|Zoop|Zoop||
Zou! Zou! Zou! Rescue Daisakusen||Zou! Zou! Zou! Rescue Daisakusen||
Zou! Zou! Zou! Rescue Daisenryaku|Zou! Zou! Zou! Rescue Daisenryaku|||
