007: The Living Daylights|007 - The Living Daylights|||
1040 Terminator|1040 Terminator|||
180|180|||
221 B Baker St.|221B Baker Street||221B Baker Street|
3d24|3d24|||
3-D Noughts & Crosses|3-D Noughts & Crosses|||
3-D Pac Plus|3-D Pac Plus|||
3-D Red Baron|3-D Red Baron||3-D Red Baron|
3-D Tic-Tac-Toe|3-D Tic-Tac-Toe||3-D Tic-Tac-Toe|
747 Flight Simulator|747 Flight Simulator||747 Flight Simulator|
747 Landing Simulator|747 Landing Simulator|||
Abracadabra|Abracadabra!||Abracadabra!|
Abraxas Adventure #1: Assault on the Astral Rift|Abraxas Adventure #1 - Assault on the Astral Rift|||
Abuse|Abuse|||
Accion|Accion|||
Ace Dribbler and the Roadhogs|Ace Dribbler and the Roadhogs|||
Ace of Aces|Ace of Aces||Ace of Aces|
Acey-Deucey|Acey-Deucey|||
Acrobat|Acrobat|||
Action Adventures|Action Adventures|||
Action Biker|Action Biker||Action Biker|
Action Quest|Action Quest|||
AD 2044|AD 2044|||
Adax|Adax|||
Advanced Air Traffic Controller|Advanced Air Traffic Controller|||
Advanced Pinball Simulator|Advanced Pinball Simulator|||
Adventure!|Adventure!|||
Adventure Creator|Adventure Creator|||
Adventure in Time|Adventure in Time|||
Adventure Master|Adventure Master|||
Adventure No. 01: Adventureland|Adventure No. 01 - Adventureland|||
Adventure No. 02: Pirate Adventure|Adventure No. 02 - Pirate Adventure|||
Adventure No. 03: Mission Impossible|Adventure No. 03 - Mission Impossible|||
Adventure No. 04: Voodoo Castle|Adventure No. 04 - Voodoo Castle|||
Adventure No. 05: The Count|Adventure No. 05 - The Count|||
Adventure No. 06: Strange Odyssey|Adventure No. 06 - Strange Odyssey|||
Adventure No. 07: Mystery Fun House|Adventure No. 07 - Mystery Fun House|||
Adventure No. 08: Pyramid of Doom|Adventure No. 08 - Pyramid of Doom|||
Adventure No. 09: Ghost Town|Adventure No. 09 - Ghost Town|||
Adventure No. 10: Savage Island: Part I|Adventure No. 10 - Savage Island - Part I|||
Adventure No. 11: Savage Island: Part II|Adventure No. 11 - Savage Island - Part II|||
Adventure No. 12: The Golden Voyage|Adventure No. 12 - The Golden Voyage|||
Adventure No. 13: The Sorcerer of Claymorgue Castle|Adventure No. 13 - The Sorcerer of Claymorgue Castle|||
Adventure on a Boat|Adventure on a Boat|||
Adventure Pack|Adventure Pack|||
Adventure Quest|Adventure Quest|||
Adventure Telephone|Adventure Telephone|||
AdventureWriter|AdventureWriter|||
A-E|A-E|||
Aerobics|Aerobics|||
AffenJagd|AffenJagd|||
After Pearl|After Pearl|||
Agent USA|Agent USA|||
Agonia|Agonia|||
Air Attack|Air Attack|||
Airball|AirBall|||
Airline|Airline|||
Air-Raid!|Air-Raid!|||
Air Rescue|Air Rescue|||
Airstrike|Airstrike|||
Airstrike II|Airstrike II|||
Air Support|Air Support|||
Airwolf|Airwolf|||
Aladin|Aladin|||
Alchemia|Alchemia|||
Alex|Alex|||
ALF in the Color Caves|Alf in the Color Caves|||
Aliants|Aliants|||
Ali Baba and the Forty Thieves|Ali Baba And The Forty Thieves|||
Alien Ambush|Alien Ambush|||
Alien Attack|Alien Attack|||
Alien Blast|Alien Blast|||
Alienbusters|Alienbusters|||
Aliencounter & Faceflash|Aliencounter & Faceflash|||
Alien Egg|Alien Egg|||
Alien Garden|Alien Garden|||
Alien Hell|Alien Hell|||
Alien Swarm|Alien Swarm|||
Alley Cat|Alley Cat|||
All-Pro Football|All-Pro Football|||
All Star Baseball|All Star Baseball|||
Alphabet Factory|Alphabet Factory|||
Alphabetizing|Alphabetizing|||
Alphabet Zoo|Alphabet Zoo|||
Alpha Shield|Alpha Shield|||
Alp Man|Alp Man|||
Alternate Reality Dungeon Character Editor!|Alternate Reality Dungeon Character Editor!|||
Alternate Reality: The City|Alternate Reality - The City|||
Alternate Reality: The Dungeon|Alternate Reality - The Dungeon|||
Alternity|Alternity|||
Amaurote|Amaurote|||
Amazing!|Amazing!|||
Amnesia|Amnesia|||
Amphibian!|Amphibian!|||
Anagrams|Anagrams|||
Android|Android|||
Android Attack|Android Attack|||
Andromeda|Andromeda|||
Andromeda Conquest|Andromeda Conquest|||
Angle Worms|Angle Worms|||
Animal Party|Animal Party|||
Animal World|Animal World|||
Animated Puzzle|Animated Puzzle|||
Ankh|Ankh|||
Ant Eater|Ant Eater|||
Anthill|Anthill|||
Anti-Sub Patrol|Anti-Sub Patrol|||
Apple Invaders|Apple Invaders|||
Apple Panic|Apple Panic|||
Aqua Marina|Aqua Marina|||
Aquatron|Aquatron|||
Arcade Attack|Arcade Attack|||
Arcade Bonanza|Arcade Bonanza|||
Arcade Fruit Machine|Arcade Fruit Machine|||
Arcade II|Arcade II|||
Arcademic SkillBuilder: Alligator Mix|Arcademic SkillBuilder - Alligator Mix|||
Arcademic SkillBuilder: Dragon Mix|Arcademic SkillBuilder - Dragon Mix|||
Arcademic SkillBuilder: Word Invasion|Arcademic SkillBuilder - Word Invasion|||
Arcademic SkillBuilder: Word Master|Arcademic SkillBuilder - Word Master|||
Arcanoid IV|Arcanoid IV|||
Archon|Archon|||
Archon II: Adept|Archon II - Adept|||
Ardy the Aardvark|Ardy the Aardvark|||
Arena 3000|Arena 3000|||
Arex|Arex|||
Arkanoid|Arkanoid|||
Arkanoid II|Arkanoid II|||
Armor Assault|Armor Assault|||
Arno Boulder Dash 1|Arno Boulder Dash 1|||
Arno Boulder Dash 2|Arno Boulder Dash 2|||
Arno Boulder Dash 3|Arno Boulder Dash 3|||
Arno Boulder Dash 4|Arno Boulder Dash 4|||
Arno Boulder Dash 5|Arno Boulder Dash 5|||
Arno Boulder Dash 6|Arno Boulder Dash 6|||
Around the Planet|Around the Planet|||
Around the World|Around the World|||
Artefakt Przodkow|Artefakt Przodkow|||
Ashido|Ashido|||
Assassin's Cove|Assassin's Cove|||
Assault Force 3-D|Assault Force 3-D|||
Assembloids XE|Assembloids XE|||
Asteroid Miners|Asteroid Miners|||
Asteroids|Asteroids|||
Asteroids Emulator|Asteroids Emulator|||
Asteroids II|Asteroids II|||
Asteroid Storm|Asteroid Storm|||
Astra Phantasm|Astra Phantasm|||
Astro Chase|Astro Chase|||
Astro-Droid|Astro-Droid|||
Astro-Grover|Astro-Grover|||
Astrology|Astrology|||
Astromeda|Astromeda|||
Astron IV|Astron IV|||
Astron IX|Astron IX|||
Astro-Quotes: Game #1|Astro-Quotes - Game #1|||
Astro-Quotes: Game #2|Astro-Quotes - Game #2|||
Astro-Quotes: Game #3|Astro-Quotes - Game #3|||
Astro Road|Astro Road|||
Astrowarriors|Astrowarriors|||
Atalan Sokoban|Atalan Sokoban|||
Atalan Tetris|Atalan Tetris|||
Atalan the Snake|Atalan the Snake|||
Atari Invaders|Atari Invaders|||
AtariOracle|AtariOracle|||
Atari Safari|Atari Safari|||
Atari Smash Hits: Volume 1|Atari Smash Hits - Volume 1|||
Atari Smash Hits: Volume 2|Atari Smash Hits - Volume 2|||
Atari Smash Hits: Volume 3|Atari Smash Hits - Volume 3|||
Atari Tarots|Atari Tarots|||
Atari XL Sokoban|Atari XL Sokoban|||
Atarzee|Atarzee|||
Atlantis|Atlantis|||
Atlantis Boulder Dash|Atlantis Boulder Dash|||
Atlantis Revenge|Atlantis Revenge|||
Atlas of Canada|Atlas of Canada|||
Atomia|Atomia|||
Atomic Gnom|Atomic Gnom|||
Atomit II|Atomit II|||
Atom Smasher|Atom Smasher|||
Attack at EP-CYG-4|Attack at EP-CYG-4|||
Attack of the Mutant Camels|Attack of the Mutant Camels|||
Attank!|Attank!|||
At the Codfish Ball|At the Codfish Ball|||
AURA Adventures|AURA Adventures|||
Aurum|Aurum|||
Autoduel|AutoDuel|||
Avalanche|Avalanche|||
Axilox|Axilox|||
Axis Assassin|Axis Assassin|||
A-Zone|A-Zone|||
Aztec|Aztec|||
Aztec Challenge|Aztec Challenge|||
Aztek's Revenge|Aztek's Revenge|||
B-1 Nuclear Bomber|B-1 Nuclear Bomber|||
Baa, Baa, Black Sheep|Baa, Baa, Black Sheep|||
Babel|Babel|||
Backgammon|Backgammon|||
Bacterion!|Bacterion!|||
Bagels Supreme|Bagels Supreme|||
Baja Buggies|Baja Buggies|||
Ballblazer|Ballblazer|||
Ball-Cracker|Ball-Cracker|||
Ballistic Interceptor|Ballistic Interceptor|||
Balloon Crazy|Balloon Crazy|||
Balloon Pop|Balloon Pop|||
Balloon Pop & Pylon Racer|Balloon Pop & Pylon Racer|||
Ballyhoo|Ballyhoo|||
Balz|Balz|||
Banana|Banana|||
Bandits|Bandits|||
Bank Bang!|Bank Bang!|||
Banker's Run!|Banker's Run!|||
Bannercatch|Bannercatch|||
Banzai|Banzai|||
Barbarian|Barbarian|||
Barge|Barge|||
Barkonid|Barkonid|||
Barnstorm|Barnstorm|||
Barnyard Blaster|Barnyard Blaster|||
Baseball|Baseball|||
Basil the Great Mouse Detective|Basil the Great Mouse Detective|||
Basketball|Basketball|||
Battalion Commander|Battalion Commander|||
Battlecruiser I|Battlecruiser I|||
Battle for Normandy|Battle for Normandy|||
Battle of Antietam|Battle of Antietam|||
Battle Of Britain|Battle Of Britain|||
Battle Ships|Battle Ships|||
Battle Trek|Battle Trek|||
Battlezone|BattleZone|||
Battling Bugs & Concentraction|Battling Bugs & Concentraction|||
Batty Builders|Batty Builders|||
BC's Quest for Tires|BC's Quest for Tires|||
Beach Head|Beach Head|||
Beach Head II: The Dictator Strikes Back|Beach Head II - The Dictator Strikes Back|||
Beach Landing|Beach Landing|||
Beamrider|Beamrider|||
Beat the Beatles|Beat the Beatles|||
Beef Drop|Beef Drop|||
Beer Belly Burt's Brew Biz|Beer Belly Burt's Brew Biz|||
Belljumper 1K|Belljumper 1K|||
Bellum|Bellum|||
Beneath Apple Manor: The Special Edition|Beneath Apple Manor - The Special Edition|||
Beneath the Pyramids|Beneath the Pyramids|||
Berserker Raids|Berserker Raids|||
Bertyx|Bertyx|||
Berzerk|Berzerk|||
Beta Fighter|Beta Fighter|||
Beyond Castle Wolfenstein|Beyond Castle Wolfenstein|||
Bible Baseball|Bible Baseball|||
Big Bird's Funhouse|Big Bird's Funhouse|||
Big Bird's Special Delivery|Big Bird's Special Delivery|||
Big Math Attack|Big Math Attack|||
Bilbo|Bilbo|||
Billiards|Billiards|||
Bio-Defense|Bio-Defense|||
Birth of the Phoenix|Birth of the Phoenix|||
Bishop's Square & Maxwell's Demon|Bishop's Square & Maxwell's Demon|||
Bismarck|Bismarck|||
Blackhawk|Blackhawk|||
Blackjack|Blackjack|||
Blackjack Casino|Blackjack Casino|||
Black Lamp|Black Lamp|||
Black Out|Black Out|||
Blaster|Blaster|||
Blinky's Scary School|Blinky's Scary School|||
Blip!|Blip!|||
Blockaboo!|Blockaboo!|||
Blockade|Blockade|||
Blockbuster|Blockbuster|||
Block'em|Block'em|||
Blue Max 2001|Blue Max 2001|||
Blue Max|Blue Max|||
Blueprint|Blueprint|||
Blue Team Bridge|Blue Team Bridge|||
Blue Thunder|Blue Thunder|||
BMX Simulator|BMX Simulator|||
Body Parts|Body Parts|||
Boing II|Boing II|||
Bombastic!|Bombastic!|||
Bombay|Bombay|||
Bomber Attack|Bomber Attack|||
Bomber Jack|Bomber Jack|||
Bomb Fusion|Bomb Fusion|||
Bomb Hunter|Bomb Hunter|||
Bombi|Bombi|||
Bomb Jack|Bomb Jack|||
Bootleg|Bootleg|||
Bop'N Wrestle|Bop'N Wrestle|||
Boulder Dash|Boulder Dash|||
Boulder Dash Construction Kit|Boulder Dash Construction Kit|||
Boulder Dash II|Boulder Dash II|||
Boulder Dash III|Boulder Dash III|||
Boulder Dash: Professional Version|Boulder Dash - Professional Version|||
Boulders and Bombs|Boulders and Bombs|||
Bounty Bob Strikes Back!|Bounty Bob Strikes Back!|||
Bowling I|Bowling I|||
Bowling Version 2|Bowling Version 2|||
Brain Strainers|Brain Strainers|||
Break It|Break It|||
Breakthrough in the Ardennes|Breakthrough in the Ardennes|||
Breath of the Dragon|Breath of the Dragon|||
Brian Clough's Football Fortunes|Brian Clough's Football Fortunes|||
Bridge 2.0|Bridge 2.0|||
Bridge 4.0|Bridge 4.0|||
Bridge 5.0|Bridge 5.0|||
Bridge Crosser|Bridge Crosser|||
Bridge Master|Bridge Master|||
BridgePro|BridgePro|||
Brimstone|Brimstone|||
Bristles|Bristles|||
British Heritage Jigsaw Puzzles Volume 1: London Bridge|British Heritage Jigsaw Puzzles Volume 1 - London Bridge|||
British Heritage Jigsaw Puzzles Volume 1: Tower of London|British Heritage Jigsaw Puzzles Volume 1 - Tower of London|||
British Heritage Jigsaw Puzzles Volume 2 : Anne Hathaway's Cottage|British Heritage Jigsaw Puzzles Volume 2  - Anne Hathaway's Cottage|||
British Heritage Jigsaw Puzzles Volume 2 : Windsor Castle|British Heritage Jigsaw Puzzles Volume 2  - Windsor Castle|||
Broadsides|Broadsides|||
Bros|Bros|||
Bruce Lee|Bruce Lee|||
Brutal Karate|Brutal Karate|||
Bubbles|Bubbles|||
Bubble Trouble|Bubble Trouble|||
Bubble Zone|Bubble Zone|||
Buck Rodgers|Buck Rodgers|||
Buffalo Stampede|Buffalo Stampede|||
Bug Attack|Bug Attack|||
Bug Hunt|Bug Hunt|||
Bug Off!|Bug Off!|||
Bugrunner|Bugrunner|||
Bull and Cow|Bull and Cow|||
Bulldog|Bulldog|||
Bumperball|Bumperball|||
Bumper Pool|Bumper Pool|||
Bumpomov's Dogs|Bumpomov's Dogs|||
Burger Boy!|Burger Boy!|||
Burger Chef|Burger Chef|||
Burgers!|Burgers!|||
Buried Bucks|Buried Bucks|||
Busy Baby|Busy Baby|||
Buzzword|Buzzword|||
California Run|California Run|||
Callisto|Callisto|||
Cameleon|Cameleon|||
Candy Factory|Candy Factory|||
Cannibals|Cannibals|||
Can't Quit|Can't Quit|||
Canyon Climber|Canyon Climber|||
Captain Beeble|Captain Beeble|||
Captain Cosmo|Captain Cosmo|||
Captain Gather|Captain Gather|||
Captain Sticky's Gold|Captain Sticky's Gold|||
Captivity|Captivity|||
Capture the Flag|Capture the Flag|||
CardioQuiz|CardioQuiz|||
Cargar|Cargar|||
Carnival Massacre|Carnival Massacre|||
Carrier Force|Carrier Force|||
Casebook of Hemlock Soames #1,The|Casebook of Hemlock Soames #1,The|||
Casino Blackjack Counter|Casino Blackjack Counter|||
Casino Parlor Games|Casino Parlor Games|||
Cassette 50|Cassette 50|||
Castle Assault|Castle Assault|||
Castle|Castle|||
Castle Crisis|Castle Crisis|||
Castle Hassle|Castle Hassle|||
Castle Keeper|Castle Keeper|||
Castle Top|Castle Top|||
Castle Wolfenstein|Castle Wolfenstein|||
Catapault|Catapault|||
Catapede|Catapede|||
Caterpiggle|Caterpiggle|||
Cat-Nap|Cat-Nap|||
Cavelord|Cavelord|||
Caveman|Caveman|||
Cavepac|Cavepac|||
Cavern Commander|Cavern Commander|||
Cavernia|Cavernia|||
Caverns of Callisto|Caverns of Callisto|||
Caverns of Eriban|Caverns of Eriban|||
Caverns of Khafka|Caverns of Khafka|||
Caverns of Mars|Caverns of Mars|||
Caverns of Mars II|Caverns of Mars II|||
Caverns of the Lost Miner|Caverns of the Lost Miner|||
Caves of Rigel|Caves of Rigel|||
Cecil|Cecil|||
Cecil II|Cecil II|||
Cellar Terror|Cellar Terror|||
Cells and Serpents|Cells and Serpents|||
Cementerio|Cementerio|||
Centipede|Centipede|||
Centurion|Centurion|||
Centurion: Defender of Rome|Centurion - Defender of Rome|||
C'est La Vie|C'est la Vie|||
Chambers of Zorp|Chambers of Zorp|||
Championship Golf|Championship Golf|||
Championship Lode Runner|Championship Lode Runner|||
Chancellor Of The Exchequer|Chancellor of the Exchequer|||
Change|Change|||
Chase|Chase|||
Chatterbee|Chatterbee|||
Checker King|Checker King|||
Checkers|Checkers|||
Chem Lab|Chem Lab|||
Chess|Chess|||
Chicken Chase|Chicken Chase|||
Chicken|Chicken|||
Chimera|Chimera|||
Chinese Puzzle|Chinese Puzzle|||
Chomper|Chomper|||
Choplifter!|Choplifter!|||
Chopper Chase|Chopper Chase|||
Chopper Hunt|Chopper Hunt|||
Chopper Rescue|Chopper Rescue|||
Chop Suey|Chop Suey|||
Christmas Eve Nightmare, A|Christmas Eve Nightmare, A|||
Chromatics|Chromatics|||
Chuckie Egg|Chuckie Egg|||
Cimex Rex|Cimex Rex|||
Circo Bianco|Circo Bianco|||
Citadel Warrior|Citadel Warrior|||
Cityhawk|Cityhawk|||
Claim Jumper|Claim Jumper|||
Clash of Wills|Clash of Wills|||
Classic|Classic|||
Classy Chassy|Classy Chassy|||
Clear for Action|Clear for Action|||
Clipper|Clipper|||
Cloak of Death|Cloak of Death|||
Clonus|Clonus|||
Clonus II|Clonus II|||
Close Assault|Close Assault|||
Cloudburst|Cloudburst|||
Clowns & Balloons|Clowns & Balloons|||
Coco-Notes|Coco-Notes|||
Codebreaker|Codebreaker|||
Codecracker|Codecracker|||
Cohen's Towers|Cohen's Towers|||
Collapse|Collapse|||
Collision Course|Collision Course|||
Colonial Conquest|Colonial Conquest|||
Colony 7|Colony 7|||
Colony|Colony|||
Colorasaurus|Colorasaurus|||
Colossus Chess 3.0|Colossus Chess 3.0|||
Colossus Chess 4.0|Colossus Chess 4.0|||
Combat Chess|Combat Chess|||
Combat Leader|Combat Leader|||
Commando|Commando|||
Commbat|Commbat|||
Compute 4 & Reversi|Compute 4 & Reversi|||
Computer Acquire|Computer Acquire|||
Computer Ambush|Computer Ambush|||
Computer Baseball|Computer Baseball|||
Computer Baseball Strategy|Computer Baseball Strategy|||
Computer Chess|Computer Chess|||
Computer Crosswords: Dell|Computer Crosswords - Dell|||
Computer Crosswords: The New York Times: Volume 1|Computer Crosswords - The New York Times - Volume 1|||
Computer Crosswords: The New York Times: Volume 2|Computer Crosswords - The New York Times - Volume 2|||
Computer Facts in Five|Computer Facts in Five|||
Computer Football Strategy|Computer Football Strategy|||
Computer Quarterback|Computer Quarterback|||
Computer Stocks and Bonds|Computer Stocks and Bonds|||
Computer Title Bout|Computer Title Bout|||
Computer War|Computer War|||
Conan|Conan|||
Concentration|Concentration|||
Condensation|Condensation|||
Conflict in Vietnam|Conflict in Vietnam|||
Congo Bongo|Congo Bongo|||
Con-Putation|Con-Putation|||
Conquest of the Crown|Conquest of the Crown|||
Contagion & Z-Force|Contagion & Z-Force|||
Controller|Controller|||
Convention|Convention|||
Cops 'N' Robbers|Cops 'N' Robbers|||
Copter Chase|Copter Chase|||
Cosmic Balance|Cosmic Balance|||
Cosmic Balance II|Cosmic Balance II|||
Cosmic Hero|Cosmic Hero|||
Cosmic Life|Cosmic Life|||
Cosmic Pirate|Cosmic Pirate|||
Cosmic Tunnels|Cosmic Tunnels|||
Cosmic Zap|Cosmic Zap|||
Countdown|Countdown|||
Count Down|Count Down|||
Count Dracula|Count Dracula|||
Counter|Counter|||
CounterMeasure|CounterMeasure|||
Crack-Up!|Crack-Up!|||
Cranston Manor Adventure|Cranston Manor Adventure|||
Craps Simulator|Craps Simulator|||
Crazy Balloon|Crazy Balloon|||
Crazy Clown Jumper|Crazy Clown Jumper|||
Crazy Cobra|Crazy Cobra|||
Crazy Ed|Crazy Ed|||
Crazy Egon|Crazy Egon|||
Crazy Quader|Crazy Quader|||
Creature Creator|Creature Creator|||
Creep|Creep|||
Creepers|Creepers|||
Creepy Caverns|Creepy Caverns|||
Cribbage|Cribbage|||
Cribbage & Dominoes|Cribbage & Dominoes|||
Crime Buster|Crime Buster|||
Crisis Mountain|Crisis Mountain|||
Crix|Crix|||
Crockford's Trench|Crockford's Trench|||
Cropky|Cropky|||
Crossbow|Crossbow|||
Crosscheck|Crosscheck|||
Crossfire|Crossfire|||
Cross-Town Crazy Eight|Cross-Town Crazy Eight|||
Crossword Magic|Crossword Magic|||
Crownland|Crownland|||
Crumble's Crisis|Crumble's Crisis|||
Crusade in Europe|Crusade in Europe|||
Crush Crumble and Chomp|Crush Crumble and Chomp|||
Crypto Cube|Crypto Cube|||
Crypto-Mania|Crypto-Mania|||
Crypts of Egypt|Crypts of Egypt|||
Crypts of Plumbous|Crypts of Plumbous|||
Crypts of Terror|Crypts of Terror|||
Crystal Castles|Crystal Castles|||
Crystal Raider|Crystal Raider|||
CTetris4|CTetris4|||
Cubbyholes|Cubbyholes|||
Cube|Cube|||
Cubemeister|Cubemeister|||
Cubico|Cubico|||
Cultivation|Cultivation|||
Cuthbert Goes Walkabout|Cuthbert Goes Walkabout|||
Cutthroats|Cutthroats|||
Cybernome|Cybernome|||
Cyborg|Cyborg|||
Cyborg Warrior|Cyborg Warrior|||
Cybor-Stien|Cybor-Stien|||
Cycleknight|Cycleknight|||
Cyclod|Cyclod|||
Cygnus Senese|Cygnus Senese|||
Cygnus X1|Cygnus X1|||
Cypher Bowl|Cypher Bowl|||
Cytron Masters|Cytron Masters|||
Cywilizacja|Cywilizacja|||
Czarny Orzel|Czarny Orzel|||
Czaszki|Czaszki|||
Da' Fuzz|Da' Fuzz|||
Dagobar|Dagobar|||
Dambusters|Dambusters|||
Dance Fantasy|Dance Fantasy|||
Dancing Feats|Dancing Feats|||
Dandy|Dandy|||
Dandy Dungeon Levels 1|Dandy Dungeon Levels 1|||
Dandy Dungeon Levels 2|Dandy Dungeon Levels 2|||
Dandy Dungeon Levels 3|Dandy Dungeon Levels 3|||
Dandy Dungeon Levels 4|Dandy Dungeon Levels 4|||
Dandy Dungeon Levels 5|Dandy Dungeon Levels 5|||
Dandy Dungeon Levels 6|Dandy Dungeon Levels 6|||
Danger Crosswalk|Danger Crosswalk|||
Danger Ranger|Danger Ranger|||
Dan Strikes Back|Dan Strikes Back|||
Darg|Darg|||
Dark Abyss|Dark Abyss|||
Dark Chambers|Dark Chambers|||
Darkness Hour|Darkness Hour|||
Dark Star|Dark Star|||
Darts|Darts|||
David's Midnight Magic|David's Midnight Magic|||
Dawn of Civilization|Dawn of Civilization|||
Dawn Raider|Dawn Raider|||
Day at the Races, A|Day at the Races, A|||
Daylight Robbery|Daylight Robbery|||
Day to Find Out, A|Day to Find Out, A|||
D-Bug|D-Bug|||
Deadline|Deadline|||
Deathchase XE|Deathchase XE|||
Deathland|DeathLand|||
Death Race|Death Race|||
Death Races|Death Races|||
Decathlon|Decathlon|||
Decision in the Desert|Decision in the Desert|||
Defend|Defend|||
Defender|Defender|||
Defensor|Defensor|||
Deflection & Simon Says|Deflection & Simon Says|||
Deflektor|Deflektor|||
Deflektor II|Deflektor II|||
Deimos|Deimos|||
Delta Drawing|Delta Drawing|||
Deluxe Invaders|Deluxe Invaders|||
Deluxe Space Games|Deluxe Space Games|||
Demon Attack|Demon Attack|||
Demon|Demon|||
Demon Hunt|Demon Hunt|||
Denis Through the Drinking Glass|Denis through the Drinking Glass|||
De Re Pac-Man|De Re Pac-Man|||
Desert Falcon|Desert Falcon|||
Desmond's Dungeon|Desmond's Dungeon|||
Despatch Rider|Despatch Rider|||
Destiny: The Cruiser|Destiny - The Cruiser|||
Destroyer Warship|Destroyer Warship|||
Detective|Detective|||
Deuces Wild|Deuces Wild|||
Devilator|Devilator|||
Devil's Dare|Devil's Dare|||
Devil's Domain|Devil's Domain|||
Diamond Mine|Diamond Mine|||
Diamonds|Diamonds|||
Diamondz|Diamondz|||
Dice Poker|Dice Poker|||
Dig Dug|Dig Dug|||
Diggerbonk|Diggerbonk|||
Digi Duck|Digi Duck|||
Dimension X|Dimension X|||
Dinky-Do|Dinky-Do|||
Disc Hopper|Disc Hopper|||
Divex|Divex|||
Division Drill|Division Drill|||
Dizzy Dice|Dizzy Dice|||
Dnieper River Line|Dnieper River Line|||
Dodge Racer|Dodge Racer|||
Dog Daze Deluxe|Dog Daze Deluxe|||
Dog Daze|Dog Daze|||
Domination|Domination|||
Donald|Donald|||
Donkey Kong Arcade|Donkey Kong Arcade|||
Donkey Kong|Donkey Kong|||
Donkey Kong Junior|Donkey Kong Junior|||
Donny 2|Donny 2|||
Don't Shoot That Word!|Don't Shoot That Word!|||
Downhill|Downhill|||
Drac Is Back|Drac Is Back|||
Draconus|Draconus|||
Drag|Drag|||
Dragnet|Dragnet|||
Dragon Castle|Dragon Castle|||
Dragon Defense|Dragon Defense|||
Dragon Games|Dragon Games|||
Dragon Quest|Dragon Quest|||
Dragon Quest or a Twist in the Tail|Dragon Quest or a Twist in the Tail|||
Dragon's Hideaway|Dragon's Hideaway|||
Dragon's Keep|Dragon's Keep|||
Dragon's Lair|Dragon's Lair|||
Draughts|Draughts|||
Dreadnought Megastars|Dreadnought Megastars|||
Dredis|Dredis|||
Drelbs|Drelbs|||
Dr. Goodcode's Cavern|Dr. Goodcode's Cavern|||
Dr. Mario|Dr. Mario|||
Dr. Mindwarp|Dr. Mindwarp|||
Droga Wojownika|Droga Wojownika|||
Droids|Droids|||
Drol|Drol|||
Drop It|Drop It|||
Dropzone|Dropzone|||
Dr. Seuss: Fix-Up the Mix-Up Puzzler|Dr. Seuss - Fix-Up the Mix-Up Puzzler|||
Druid|Druid|||
Dual Duel|Dual Duel|||
Duch|Duch|||
Ducks Ahoy!|Ducks Ahoy!|||
Duellin' Droid|Duellin' Droid|||
Dungeon Duel|Dungeon Duel|||
DungeonLords|DungeonLords|||
Dungeons, Dragons, and Other Perils|Dungeons, Dragons, and Other Perils|||
Dungeons of Xotha|Dungeons of Xotha|||
Dunjonquest: Hellfire Warrior|Dunjonquest - Hellfire Warrior|||
Dunjonquest: Morloc's Tower|Dunjonquest - Morloc's Tower|||
Dunjonquest: Temple of Apshai|Dunjonquest - Temple of Apshai|||
Dunjonquest: The Datestones of Ryn|Dunjonquest - The Datestones of Ryn|||
Dwie Wieze|Dwie Wieze|||
Dyna Blaster|Dyna Blaster|||
Dynakillers|Dynakillers|||
Dziedzictwo Gigantow|Dziedzictwo Gigantow|||
Eagles|Eagles|||
Earth 2500|Earth 2500|||
Eastern Front 1941|Eastern Front 1941|||
East Side Story|East Side Story|||
Easy Money|Easy Money|||
Eckn|Eckn|||
Eggard|Eggard|||
Eggnapper|Eggnapper|||
Eldorado|Eldorado|||
Electra|Electra|||
Electrician|Electrician|||
Electric Starfish|Electric Starfish|||
Electro Maniac!|Electro Maniac!|||
Elektra Glide|Elektra Glide|||
Elevator Repairman|Elevator Repairman|||
Eliminator|Eliminator|||
Embargo|Embargo|||
Emerald Isle|Emerald Isle|||
Empire of the Over-Mind|Empire of the Over-Mind|||
Emulator|Emulator|||
Enchanter|Enchanter|||
Encounter at Questar IV|Encounter at Questar IV|||
Encounter!|Encounter!|||
Energy Czar|Energy Czar|||
Enigmatix!|Enigmatix!|||
Ennumereight|Ennumereight|||
Epidemic!|Epidemic!|||
Equestrian|Equestrian|||
ERG|ERG|||
Ernie's Magic Shapes|Ernie's Magic Shapes|||
Eryus|Eryus|||
Escape|Escape|||
Escape from Doomworld|Escape from Doomworld|||
Escape from Perilous|Escape from Perilous|||
Escape from Vulcan's Isle|Escape from Vulcan's Isle|||
Escape to Equatus|Escape to Equatus|||
Espial|Espial|||
Essex|Essex|||
E.T. Phone Home!|E.T. Phone Home!|||
Eureka!|Eureka!|||
European Countries and Capitals|European Countries and Capitals|||
European Scene Jigsaw Puzzles: Volume 1|European Scene Jigsaw Puzzles - Volume 1|||
European Scene Jigsaw Puzzles: Volume 2|European Scene Jigsaw Puzzles - Volume 2|||
European Super Soccer|European Super Soccer|||
Evader|Evader|||
Everest Explorer|Everest Explorer|||
Evolution|Evolution|||
Excalibur|Excalibur|||
Excelsor|Excelsor|||
Exit Watch|Exit Watch|||
Exocet Blastoff|Exocet Blastoff|||
Exploding Boulder Dash|Exploding Boulder Dash|||
Exploding Wall|Exploding Wall|||
F-15 Strike Eagle|F-15 Strike Eagle|||
FaceMaker|FaceMaker|||
Factor Blast|Factor Blast|||
Factor-X|Factor-X|||
Fairy Castle|Fairy Castle|||
Falcon|Falcon|||
Family Fun: Four Letter Word|Family Fun - Four Letter Word|||
Fantastic Soccer|Fantastic Soccer|||
Fantastic Voyage|Fantastic Voyage|||
Fantasyland 2041 A.D.|Fantasyland 2041 A.D.|||
Farao|Farao|||
Fast Eddie|Fast Eddie|||
Fastgammon|Fastgammon|||
Fatum|Fatum|||
FEAR: Figure Eight Auto Racing|FEAR - Figure Eight Auto Racing|||
Fester's Quest|Fester's Quest|||
Feud: The Graphic Adventure|Feud - The Graphic Adventure|||
Fidget|Fidget|||
Field of Fire|Field of Fire|||
Fifty Mission Crush|Fifty Mission Crush|||
Fighter Pilot|Fighter Pilot|||
Fight Night|Fight Night|||
Fill'er Up! II|Fill'er Up! II|||
Final Conflict|Final Conflict|||
Final Exam|Final Exam|||
Final Flight!|Final Flight!|||
Final Legacy|Final Legacy|||
Final Orbit|Final Orbit|||
Firebird|Firebird|||
Fire Chief|Fire Chief|||
Firefleet|Firefleet|||
Fire One!|Fire One!|||
Fire Power|Fire Power|||
Fire Stone|Fire Stone|||
Fishing Fun|Fishing Fun|||
Five Card Draw Poker|Five Card Draw Poker|||
Flak|Flak|||
Flapper|Flapper|||
Flappy|Flappy|||
Fleet|Fleet|||
Flight Simulator II|Flight Simulator II|||
Flinstone's Adventures|Flinstone's Adventures|||
Flip and Flop|Flip and Flop|||
Flowers Mania|Flowers Mania|||
Floyd of the Jungle|Floyd of the Jungle|||
Flying Ace|Flying Ace|||
Flying Tigers|Flying Tigers|||
Fog|Fog|||
Fooblitzky|Fooblitzky|||
Food Fight|Food Fight|||
Footballer of the Year|Footballer of the Year|||
Football Manager|Football Manager|||
Forbidden Forest|Forbidden Forest|||
Forest Fire|Forest Fire|||
Forest Fire Two|Forest Fire Two|||
Formula 1 Racing|Formula 1 Racing|||
Fort Apocalypse|Fort Apocalypse|||
Fortress|Fortress|||
Fortress Underground|Fortress Underground|||
Fortune Hunter|Fortune Hunter|||
Four Great Games Volume 3|Four Great Games Volume 3|||
Fraction Fever|Fraction Fever|||
Frank & Mark|Frank & Mark|||
Frantic!|Frantic!|||
Frazzle|Frazzle|||
Freaky Factory|Freaky Factory|||
Fred|Fred|||
FreeCellXE|FreeCellXE|||
FREE: Funny Risky Evil Escape|FREE - Funny Risky Evil Escape|||
Free Trader|Free Trader|||
Frenesis|Frenesis|||
Frisky Tom|Frisky Tom|||
Frogger|Frogger|||
Frogger II: Sewer Level|Frogger II - Sewer Level|||
Frogger II: Theeedeep!|Frogger II - Theeedeep!|||
Frogmaster|Frogmaster|||
Frogs|Frogs|||
Frontier Galaxy|Frontier Galaxy|||
Fruit Machine Simulator|Fruit Machine Simulator|||
Fruit Pickin'|Fruit Pickin'|||
Fruit Salad|Fruit Salad|||
Frustration|Frustration|||
Fun with Spelling|Fun with Spelling|||
Fury: The Wrath of Taljun Cathu|Fury - The Wrath of Taljun Cathu|||
Fuzzy|Fuzzy|||
Galactic Adventures|Galactic Adventures|||
Galactic Avenger|Galactic Avenger|||
Galactic Chase|Galactic Chase|||
Galactic Cresta|Galactic Cresta|||
Galactic Defender|Galactic Defender|||
Galactic Empire|Galactic Empire|||
Galactic Patrol|Galactic Patrol|||
Galactic Quest|Galactic Quest|||
Galactic Trader|Galactic Trader|||
Galahad and the Holy Grail|Galahad and the Holy Grail|||
Galaxian|Galaxian|||
Galaxi Barkonid|Galaxi Barkonid|||
Galaxy|Galaxy|||
Gallahad|Gallahad|||
Gallery of Death|Gallery of Death|||
Gambler|Gambler|||
Game Show|Game Show|||
Games Pack I|Games Pack I|||
Games Pack II|Games Pack II|||
Gamma Ray|Gamma Ray|||
Gangstersville|Gangstersville|||
Gateway to Apshai|Gateway to Apshai|||
GATO|Gato|||
Gauntletak|Gauntletak|||
Gauntlet|Gauntlet|||
Geisterschloss|Geisterschloss|||
Gemstone Warrior|Gemstone Warrior|||
Genesis|Genesis|||
Genetic Drift|Genetic Drift|||
Getaway!|Getaway!|||
Getris|Getris|||
Gettysburg: The Turning Point|Gettysburg - The Turning Point|||
GFS Sorceress|GFS Sorceress|||
Ghastly Night|Ghastly Night|||
Ghost: Always Trouble With Kids|Ghost - Always Trouble With Kids|||
Ghostbusters|Ghostbusters|||
Ghost Chaser|Ghost Chaser|||
Ghost Encounters|Ghost Encounters|||
Ghost!|Ghost!|||
Ghost Hunter|Ghost Hunter|||
Ghost Hunter II|Ghost Hunter II|||
Ghostly Goblins|Ghostly Goblins|||
Giant Slalom|Giant Slalom|||
Gigablast|Gigablast|||
Gin Rummy|Gin Rummy|||
Gladiator|Gladiator|||
Glaggs It!|Glaggs It!|||
Global War|Global War|||
Globe Master|Globe Master|||
G Men|G Men|||
Gnome Ranger|Gnome Ranger|||
Go Cart|Go Cart|||
Go Fish|Go Fish|||
Go|Go|||
Golden Gloves|Golden Gloves|||
Golden Oldies: Volume 1|Golden Oldies - Volume 1|||
Gold Hunter|Gold Hunter|||
Gold Mine|Gold Mine|||
Golf Challenge|Golf Challenge|||
Golf Championship|Golf Championship|||
Golf Classic|Golf Classic|||
Golfer|Golfer|||
Golf Master|Golf Master|||
Gomoku|Gomoku|||
Gorf|Gorf|||
Gorgon|Gorgon|||
Gossip|Gossip|||
Grandma's House|Grandma's House|||
Grand Prix Simulator|Grand Prix Simulator|||
Great War: 1914|Great War - 1914|||
Green Beret|Green Beret|||
Green Goblins|Green Goblins|||
Greenout|Greenout|||
Gremlins|Gremlins|||
Gridiron Glory|Gridiron Glory|||
Gridrunner|Gridrunner|||
Gruds In Space|Gruds in Space|||
Guard|Guard|||
Guardians of the Gorn|Guardians of the Gorn|||
Guderian|Guderian|||
Guess the Rule|Guess the Rule|||
Guess What's Coming to Dinner|Guess What's Coming to Dinner|||
Gulf Strike|Gulf Strike|||
Gumball|Gumball|||
Gun Boat|Gun Boat|||
Gunfighter|Gunfighter|||
Gunfight|Gunfight|||
Gunhead|Gunhead|||
Gun Law|Gun Law|||
Gunslinger|Gunslinger|||
Guns of Fort Defiance|Guns of Fort Defiance|||
Gwendolyn|Gwendolyn|||
Gwobby's Adventure|Gwobby's Adventure|||
Gwobby Strikes Back!|Gwobby Strikes Back!|||
GYPSY|Gypsy|||
Gyruss|Gyruss|||
H2O|H2O|||
H3x0r 1K|H3x0r 1K|||
H3x0r Deluxe|H3x0r Deluxe|||
Hacker|Hacker|||
Hail to the Chief|Hail to the Chief|||
Halftime Battlin' Bands|Halftime Battlin' Bands|||
Hammer Head|Hammer Head|||
Hangman|Hangman|||
Hans Kloss|Hans Kloss|||
HardBall|HardBall|||
Hard Hat Mack|Hard Hat Mack|||
Hard Hat Willy|Hard Hat Willy|||
HAR'em|HAR'em|||
Haunted Hill|Haunted Hill|||
Hawk Fire|Hawk Fire|||
Hawkmoon|Hawkmoon|||
Hawkquest|Hawkquest|||
Hazard Run|Hazard Run|||
Head Over Heels|Head over Heels|||
Heart Break|Heart Break|||
Hearts 1.5|Hearts 1.5|||
Heathcliff: Fun With Spelling|Heathcliff - Fun With Spelling|||
Heavy Metal|Heavy Metal|||
Heist!|Heist!|||
Helicops|Helicops|||
Heli in the Caves Extended Edition|Heli in the Caves Extended Edition|||
Helix|Helix|||
Hellcat Ace|Hellcat Ace|||
Help Saturn|Help Saturn|||
Henri|Henri|||
Henry's House|Henry's House|||
Herbert|Herbert|||
Herbert II|Herbert II|||
Her Majesty's Secret Weapon|Her Majesty's Secret Weapon|||
H.E.R.O.|H.E.R.O.|||
HexxagonXE|HexxagonXE|||
Hickory Dickory Dock|Hickory Dickory Dock|||
High Rise|High Rise|||
Highway Duel|Highway Duel|||
Hijack!|Hijack!|||
Hi-Res Adventure #0: Mission Asteroid|Hi-Res Adventure #0 - Mission Asteroid|||
Hi-Res Adventure #2: The Wizard and the Princess|Hi-Res Adventure #2 - The Wizard and the Princess|||
Hi-Res Adventure #4: Ulysses and the Golden Fleece|Hi-Res Adventure #4 - Ulysses and the Golden Fleece|||
Hi-Res Adventure #6: The Dark Crystal|Hi-Res Adventure #6 - The Dark Crystal|||
His Dark Majesty|His Dark Majesty|||
HIVMania|HIVMania|||
Hobgoblin|Hobgoblin|||
Hockey|Hockey|||
Hodge Podge|Hodge Podge|||
Hollywood Hijinx|Hollywood Hijinx|||
Homer's Honey Craze|Homer's Honey Craze|||
Honky|Honky|||
Horse Race|Horse Race|||
Hotel Alien|Hotel Alien|||
Hotfoot|Hotfoot|||
Hot Lips|Hot Lips|||
House of Usher|House of Usher|||
Hover Bovver|Hover Bovver|||
Humanoid|Humanoid|||
Humpty Dumpty|Humpty Dumpty|||
Hunchback|Hunchback|||
Hunter|Hunter|||
Hunt|Hunt|||
Hunt the Wumpas|Hunt the Wumpas|||
Hydra|Hydra|||
Hydraulik|Hydraulik|||
Hydraulik & Snowball|Hydraulik & Snowball|||
Hyperblast!|Hyperblast!|||
Hypnotic Land|Hypnotic Land|||
Ice|Ice|||
Imagine|Imagine|||
Im Namen des Koenigs|Im Namen des Koenigs|||
Impact|Impact|||
Imperial Walker|Imperial Walker|||
Imperium Galactum|Imperium Galactum|||
Incoming!|Incoming!|||
Incydent|Incydent|||
Infantry Squad|Infantry Squad|||
Inferno|Inferno|||
Infidel|Infidel|||
Infiltrator|Infiltrator|||
Ingrid's Back: Part 1|Ingrid's Back - Part 1|||
Ingrid's Back: Part 2|Ingrid's Back - Part 2|||
Ingrid's Back: Part 3|Ingrid's Back - Part 3|||
In Search of the Most Amazing Thing|In Search of the Most Amazing Thing|||
Insects|Insects|||
Inside|Inside|||
Inter Galleon Battle|Inter Galleon Battle|||
Into Deep!|Into Deep!|||
Into the Eagle's Nest|Into the Eagle's Nest|||
Intruder Alert!|Intruder Alert!|||
Intruder!|Intruder!|||
Invasion|Invasion|||
Invasion Orion|Invasion Orion|||
Ion Roadway|Ion Roadway|||
IQ Baseball|IQ Baseball|||
IQ|IQ|||
IQ Master|IQ Master|||
Isora|Isora|||
Istar Crossword|Istar Crossword|||
Ithix|Ithix|||
Ixion|Ixion|||
Jack and Jill|Jack and Jill|||
Jaffar|Jaffar|||
Jagdstaffel|Jagdstaffel|||
Ja-Jo|Ja-Jo|||
James Bond 007|James Bond 007|||
Janosik|Janosik|||
Java Jim|Java Jim|||
Jawbreaker II|Jawbreaker II|||
Jawbreaker|Jawbreaker|||
Jax-O|Jax-O|||
Jeepers Creepers|Jeepers Creepers|||
JellyBeans|JellyBeans|||
Jenny of the Prairie|Jenny of the Prairie|||
Jet Boot Jack|Jet Boot Jack|||
Jetboy|Jetboy|||
Jetix|Jetix|||
Jet Set Willy 2007|Jet Set Willy 2007|||
Jet Set Willy|Jet Set Willy|||
Jewel Bits|Jewel Bits|||
Jewels of Darkness #1: Colossal Adventure|Jewels of Darkness #1 - Colossal Adventure|||
Jewels of Darkness #2: Adventure Quest|Jewels of Darkness #2 - Adventure Quest|||
Jewels of Darkness #3: Dungeon Adventure|Jewels of Darkness #3 - Dungeon Adventure|||
Jinks|Jinks|||
Jinxter|Jinxter|||
Jocky Wilson's Darts Challenge|Jocky Wilson's Darts Challenge|||
Jocky Wilson's Darts Compedium|Jocky Wilson's Darts Compedium|||
Joe Blade II|Joe Blade II|||
Joe Blade|Joe Blade|||
Joe|Joe|||
Joe's Adventure|Joe's Adventure|||
John Anderson's Rally Speedway|John Anderson's Rally Speedway|||
Johnny the Ghost|Johnny the Ghost|||
Johny's Trouble|Johny's Trouble|||
Journey to the Planets|Journey to the Planets|||
Joust|Joust|||
Jr Pacman|Jr Pacman|||
Juggler|Juggler|||
Juggles' House|Juggles' House|||
Juggles' Rainbow|Juggles' Rainbow|||
Juice!|Juice!|||
Jumbo Jet Pilot|Jumbo Jet Pilot|||
Jumping Jack|Jumping Jack|||
Jump Jet|Jump Jet|||
Jumpman|Jumpman|||
Jumpman Junior|Jumpman Junior|||
Jungle Boy|Jungle Boy|||
Jungle Hunt|Jungle Hunt|||
Juno First|Juno First|||
Jupiter Mission 1999|Jupiter Mission 1999|||
Jurassic Park II|Jurassic Park II|||
Jurassic Park|Jurassic Park|||
Kaboom!|Kaboom!|||
Kaleidoscope|Kaleidoscope|||
Kamikaze|Kamikaze|||
Kampfgruppe|Kampfgruppe|||
Kangaroo|Kangaroo|||
Karateka|Karateka|||
Karmic Caverns|Karmic Caverns|||
Kasiarz|Kasiarz|||
Kayos|Kayos|||
Kazoo|Kazoo|||
Kennedy Approach|Kennedy Approach|||
Kenny Dalglish Soccer Manager|Kenny Dalglish Soccer Manager|||
Keno|Keno|||
Ken Uston's Professional Blackjack|Ken Uston's Professional Blackjack|||
Ken Uston's Puzzlemania|Ken Uston's Puzzlemania|||
Kernaw|Kernaw|||
Ketchup|Ketchup|||
Keyboard Organ|Keyboard Organ|||
Keystone Kapers|Keystone Kapers|||
Kickback|Kickback|||
Kick Off|Kick Off|||
Kid Grid|Kid Grid|||
Kids on Keys|Kids on Keys|||
Kid's Programs #1|Kid's Programs #1|||
Kid's Programs #2|Kid's Programs #2|||
Kiki Pong|Kiki Pong|||
Kikstart|Kikstart|||
Killa Cycle|Killa Cycle|||
KinderComp|KinderComp|||
King Arthur's Heir|King Arthur's Heir|||
King Cribbage|King Cribbage|||
Kingdom|Kingdom|||
King of Canadian|King of Canadian|||
King of the Castle|King of the Castle|||
King of the Ring|King of the Ring|||
King Tut's Tomb|King Tut's Tomb|||
Kissin' Kousins|Kissin' Kousins|||
Kitten|Kitten|||
Klatwa|Klatwa|||
Klondike Solitaire|Klondike Solitaire|||
Klony|Klony|||
Knicker-Bockers|Knicker-Bockers|||
Knight Lore|Knight Lore|||
Knight Orc|Knight Orc|||
Knights and Wizards|Knights and Wizards|||
Knights of the Desert|Knights of the Desert|||
Knights of the Round Table|Knights of the Round Table|||
Knock!|Knock!|||
Knock Out|Knock Out|||
KNOCKOUT|Knockout|||
Knossos|Knossos|||
Kolony 2106|Kolony 2106|||
Koronis Rift|Koronis Rift|||
Kosmonauti|Kosmonauti|||
Kowboj|Kowboj|||
K-Razy Antiks|K-Razy Antiks|||
Krazy Kopter|Krazy Kopter|||
K-Razy Kritters|K-Razy Kritters|||
K-Razy Shootout|K-Razy Shootout|||
K-Robbo No.1|K-Robbo No.1|||
K-Robbo No.2|K-Robbo No.2|||
K-Robbo No.3|K-Robbo No.3|||
K-Robbo No.4|K-Robbo No.4|||
Krucjata|Krucjata|||
K-Star Patrol|K-Star Patrol|||
Kult|Kult|||
Labyrinth|Labyrinth|||
Labyrinth Run|Labyrinth Run|||
Labyrinths|Labyrinths|||
Labyrinths of Kamerra|Labyrinths of Kamerra|||
Lancelot|Lancelot|||
Lapis Philosophorum: The Philosophers' Stone|Lapis Philosophorum - The Philosophers' Stone|||
Laser Ants|Laser Ants|||
Laser Cycle|Laser Cycle|||
Laser Gates|Laser Gates|||
Laser Hawk|Laser Hawk|||
Lasermania|Lasermania|||
Lasermaze|Lasermaze|||
Laser Racers|Laser Racers|||
Laser Strike|Laser Strike|||
Laser Tennis|Laser Tennis|||
Laser Wars|Laser Wars|||
Last of the Dragons|Last of the Dragons|||
Last Starfighter|Last Starfighter|||
Las Vegas Casino|Las Vegas Casino|||
Lava Run|Lava Run|||
Lawkeeper|Lawkeeper|||
Lazer Feds|Lazer Feds|||
Lazer Maze|Lazer Maze|||
Leaderboard Golf II|Leaderboard Golf II|||
Leader Board|Leader Board|||
League Challenge|League Challenge|||
Leaper|Leaper|||
Leap Frog!|Leap Frog!|||
Leap'in Lizards!|Leap'in Lizards!|||
Leapster|Leapster|||
Learning with Leeper|Learning with Leeper|||
Leather Godesses of Phobos|Leather Godesses of Phobos|||
Leggit!|Leggit!|||
Legionnaire|Legionnaire|||
Lemmings|Lemmings|||
Lemonade|Lemonade|||
Lepus Revenge|Lepus Revenge|||
Lethal Weapon|Lethal Weapon|||
Letterman|Letterman|||
Letter Tutor|Letter Tutor|||
Lifespan|Lifespan|||
Lighthouse|Lighthouse|||
Light Up!|Light Up!|||
Line Runner|Line Runner|||
Line-Up|Line-Up|||
Linking Logic|Linking Logic|||
Little 15|Little 15|||
Little Crystal|Little Crystal|||
Little Devil|Little Devil|||
Liverpool|Liverpool|||
Livewire 2|Livewire 2|||
Livewire|Livewire|||
Lizard|Lizard|||
Loco|Loco|||
Loco-Motion|Loco-Motion|||
Lode Runner|Lode Runner|||
Lode Runner's Rescue|Lode Runner's Rescue|||
Logic Levels|Logic Levels|||
LogicMaster|LogicMaster|||
Logistik|Logistik|||
Lookahead|Lookahead|||
Loops DX|Loops DX|||
Loops of Zen|Loops of Zen|||
Lord of the Orb|Lord of the Orb|||
Lords of Conquest|Lords of Conquest|||
Lords of Karma|Lords of Karma|||
Lords of Time|Lords of Time|||
Lorien's Tomb|Lorien's Tomb|||
Los Angeles 1984 Games|Los Angeles 1984 Games|||
Los Angeles SWAT|Los Angeles SWAT|||
Lost Colony|Lost Colony|||
Lost in the Labyrinth|Lost in the Labyrinth|||
Lost Tomb|Lost Tomb|||
Lowca|Lowca|||
Loydova Cesta|Loydova Cesta|||
Lucifer's Realm|Lucifer's Realm|||
Lunar Jetman|Lunar Jetman|||
Lunar Lander|Lunar Lander|||
Lunar Leeper|Lunar Leeper|||
Lunar Outpost|Lunar Outpost|||
Mad Genius|Mad Genius|||
Mad Jax|Mad Jax|||
Mad Marble|Mad Marble|||
Mad Marbles|Mad Marbles|||
Mad-Netter|Mad-Netter|||
Mad Stone|Mad Stone|||
Magia Fortuny|Magia Fortuny|||
Magia Krysztalu|Magia Krysztalu|||
Magia|Magia|||
Magic Dimension|Magic Dimension|||
Magic of Words|Magic of Words|||
Magic World|Magic World|||
Magnetit 2002|Magnetit 2002|||
Magnetit|Magnetit|||
Magneto Bugs|Magneto Bugs|||
Magneto|Magneto|||
Magnex|Magnex|||
Mahjong XE|Mahjong XE|||
Mahna-Malysz|Mahna-Malysz|||
Mail Order Monsters|Mail Order Monsters|||
Major Bronx|Major Bronx|||
Major League Hockey|Major League Hockey|||
Management Simulator|Management Simulator|||
Maniac Driver|Maniac Driver|||
Maniac Miner|Maniac Miner|||
Mankala|Mankala|||
Mapware|Mapware|||
Marathon|Marathon|||
Marauder|Marauder|||
Marbled|Marbled|||
Mario Bros.|Mario Bros.|||
Mario's Desert World|Mario's Desert World|||
Market Forces|Market Forces|||
Marketing Adventure|Marketing Adventure|||
Mars Mission II|Mars Mission II|||
Mar Tesoro|Mar Tesoro|||
Martian Castle|Martian Castle|||
Mashed Turtles|Mashed Turtles|||
M-A-S-H|M-A-S-H|||
Master Chess|Master Chess|||
Master Head|Master Head|||
MasterMatch|MasterMatch|||
Master of the Lamps|Master of the Lamps|||
Masters of Time|Masters of Time|||
MasterType|MasterType|||
Matchboxes|Matchboxes|||
Matchmaker Biology|Matchmaker Biology|||
Matchmaker Elementary Science: Grades 3-4|Matchmaker Elementary Science - Grades 3-4|||
Matchmaker Elementary Science: Grades 5-6|Matchmaker Elementary Science - Grades 5-6|||
Matchmaker Elementary Science: Grades 7-8|Matchmaker Elementary Science - Grades 7-8|||
Matchmaker French|Matchmaker French|||
Matchmaker Spanish|Matchmaker Spanish|||
Matchmaker US Government|Matchmaker US Government|||
Matchmaker Vocabulary|Matchmaker Vocabulary|||
Matchmaker World Geography|Matchmaker World Geography|||
Matchmaker World History|Matchmaker World History|||
Match Racer|Match Racer|||
Match Up|Match Up|||
Match Up!|Match Up!|||
Match Wits|Match Wits|||
Math Blaster!|Math Blaster!|||
Mathematics Action Games: Picture Parts|Mathematics Action Games - Picture Parts|||
Mathematics Action Games: Space Journey|Mathematics Action Games - Space Journey|||
Mathematics Action Games: Star Maze|Mathematics Action Games - Star Maze|||
Mathematic-Tac-Toe|Mathematic-Tac-Toe|||
Math Encounter|Math Encounter|||
Math Football|Math Football|||
Math Maze|Math Maze|||
Math Mileage|Math Mileage|||
Math Mission|Math Mission|||
Maths for Fun|Maths for Fun|||
Math-UFO|Math-UFO|||
Mathworld Commander|Mathworld Commander|||
Matta Blatta|Matta Blatta|||
Matterhorn|Matterhorn|||
Maxi Golf|Maxi Golf|||
Max|Max|||
Maxwell Manor: Skull of Doom|Maxwell Manor - Skull of Doom|||
Maxwell's Demon & Memory Mania|Maxwell's Demon & Memory Mania|||
Mayska Dlazba|Mayska Dlazba|||
Mazezam|Mazezam|||
McDonald's|McDonald's|||
Mean 18|Mean 18|||
Mech Brigade|Mech Brigade|||
Mediator|Mediator|||
Megablast|Megablast|||
MegaGun|MegaGun|||
Megalegs|Megalegs|||
Megamania|MegaMania|||
Meltdown|Meltdown|||
Melt-Down|Melt-Down|||
Memory Builder: Concentration|Memory Builder - Concentration|||
Memory Manor|Memory Manor|||
Memory Match|Memory Match|||
Mensa Master|Mensa Master|||
Mental Age|Mental Age|||
Mercenary: Escape From Targ|Mercenary - Escape From Targ|||
Meteor|Meteor|||
Meteor Storm|Meteor Storm|||
Metro Dome|Metro Dome|||
Mickey in the Great Outdoors|Mickey in the Great Outdoors|||
Micro Chess|Micro Chess|||
Micro League Baseball|Micro League Baseball|||
MicroMan|Microman|||
MicroSailing|MicroSailing|||
Micro Shuttle|Micro Shuttle|||
Microworld|Microworld|||
Microx|Microx|||
Middle Earth: The Ring|Middle Earth - The Ring|||
MIDI Maze|MIDI Maze|||
Midnight|Midnight|||
Midway Campaign|Midway Campaign|||
Midway|Midway|||
Miecze Valdgira II: Wladca Gor|Miecze Valdgira II - Wladca Gor|||
Miecze Valdgira|Miecze Valdgira|||
MiG Alley Ace|MIG Alley Ace|||
Mighty Jill Off|Mighty Jill Off|||
Mike's Slot Machine II|Mike's Slot Machine II|||
Milk Nuts|Milk Nuts|||
Milk Race|Milk Race|||
Millionaire|Millionaire|||
Millipede|Millipede|||
Millipedes|Millipedes|||
Mind Blast|Mind Blast|||
Mind Bogglers I: Capture|Mind Bogglers I - Capture|||
Mind Bogglers I: Mystery Box|Mind Bogglers I - Mystery Box|||
Mind Bogglers I: Simon Says|Mind Bogglers I - Simon Says|||
Mind Master|Mind Master|||
Mind Mazes|Mind Mazes|||
Mindshadow|Mindshadow|||
Mindwheel|Mindwheel|||
Miner 2049er|Miner 2049er|||
Mines!|Mines!|||
Minesweeper|Minesweeper|||
Miniature Golf Plus|Miniature Golf Plus|||
Mini-Crossword|Mini-Crossword|||
Mirax Force|Mirax Force|||
Misja|Misja|||
Missile Action|Missile Action|||
Missile Command|Missile Command|||
Missing Links|Missing Links|||
Missing: One Droid|Missing - One Droid|||
Mission|Mission|||
Mission on Thunderhead: Operation Tempest|Mission on Thunderhead - Operation Tempest|||
Mission Zircon|Mission Zircon|||
Mixtrood|Mixtrood|||
MJR Boulder Dash II|MJR Boulder Dash II|||
MJR Boulder Dash|MJR Boulder Dash|||
Mogul Maniac|Mogul Maniac|||
Molecule Arthur|Molecule Arthur|||
Molecule Man|Molecule Man|||
Monarch|Monarch|||
Monday Morning Manager|Monday Morning Manager|||
Monex|Monex|||
Monkey Magic|Monkey Magic|||
Monkeymath|Monkeymath|||
Monkey See, Monkey Spell|Monkey See, Monkey Spell|||
Monkey up a Tree|Monkey Up a Tree|||
Monster Hunt|Monster Hunt|||
Monster Maze|Monster Maze|||
Monster Smash!|Monster Smash!|||
Monstrum|Monstrum|||
Montezuma's Revenge|Montezuma's Revenge|||
Montezuma Strikes Back|Montezuma Strikes Back|||
Moogles|Moogles|||
Moonbase IO|Moonbase IO|||
Moon Beam Arcade|Moon Beam Arcade|||
Moon Marauder|Moon Marauder|||
Moonmist|Moonmist|||
Moon Patrol|Moon Patrol|||
Moon Probe|Moon Probe|||
Moon Shuttle|Moon Shuttle|||
Mordon's Quest|Mordon's Quest|||
Motorcross 800|Motorcross 800|||
Mountain Bike|Mountain Bike|||
Mountain King|Mountain King|||
Mountain Shoot|Mountain Shoot|||
Mouse Quest|Mouse Quest|||
Mouse Trap|Mouse Trap|||
Mouskattack|Mouskattack|||
Movie Musical Madness|Movie Musical Madness|||
Moving Maze|Moving Maze|||
Mr. Bear|Mr. Bear|||
MRCA Mach 2 Combat Flight Simulator|MRCA Mach 2 Combat Flight Simulator|||
Mr. Cool|Mr. Cool|||
Mr. Dig|Mr. Dig|||
Mr. Do!|Mr. Do!|||
Mr. Do's Castle|Mr. Do's Castle|||
Mr. Robot and His Robot Factory|Mr. Robot and His Robot Factory|||
Mr. Robot II|Mr. Robot II|||
Mr. TNT|Mr. TNT|||
Ms. Pac-Man|Ms. Pac-Man|||
Muff|Muff|||
Mugwump|Mugwump|||
M.U.L.E.|M.U.L.E.|||
Mule Wars|Mule Wars|||
Munching Mandy|Munching Mandy|||
Munchy|Munchy|||
Murder at Awesome Hall|Murder at Awesome Hall|||
Murder on the Zinderneuf|Murder on the Zinderneuf|||
Musical Pilot|Musical Pilot|||
Music Painter|Music Painter|||
Mutant Bats|Mutant Bats|||
Mychess II|Mychess II|||
Myriapod|Myriapod|||
Mysterious Adventure #02: The Time Machine|Mysterious Adventure #02 - The Time Machine|||
Mysterious Adventure #03: Arrow of Death Part 1|Mysterious Adventure #03 - Arrow of Death Part 1|||
Mysterious Adventure #04: Arrow of Death Part 2|Mysterious Adventure #04 - Arrow of Death Part 2|||
Mysterious Adventure #05: Escape From Pulsar 7|Mysterious Adventure #05 - Escape From Pulsar 7|||
Mysterious Adventure #06: Circus|Mysterious Adventure #06 - Circus|||
Mysterious Adventure #07: Feasibility Experiment|Mysterious Adventure #07 - Feasibility Experiment|||
Mysterious Adventure #09: Perseus & Andromeda|Mysterious Adventure #09 - Perseus & Andromeda|||
Mysterious Adventure #10: Ten Little Indians|Mysterious Adventure #10 - Ten Little Indians|||
Mysterious Adventure #11: Waxworks|Mysterious Adventure #11 - Waxworks|||
Nadral|Nadral|||
Najemnik|Najemnik|||
Najemnik: Powrot|Najemnik - Powrot|||
Name|HyperList|NoIntro|TOSEC|ReDump
NAM|NAM|||
Napoleon at Waterloo|Napoleon at Waterloo|||
Napoleon in Russia|Napoleon in Russia|||
National Flags|National Flags|||
NATO Commander|NATO Commander|||
Naturix|Naturix|||
Nautilus|Nautilus|||
Nazz|Nazz|||
Nebs|Nebs|||
Necromancer|Necromancer|||
Neptune's Daughters|Neptune's Daughters|||
Nerm of Bemer|Nerm Of Bemer|||
Neron|Neron|||
Neuroid|Neuroid|||
New York City: The Big Apple|New York City - The Big Apple|||
Nexus|Nexus|||
Nexuss MCMLXXXVIII: Part I|Nexuss MCMLXXXVIII - Part I|||
Nibbler|Nibbler|||
Nibbly|Nibbly|||
Night Driver|Night Driver|||
Night Escape|Night Escape|||
Night Flyer|Night Flyer|||
Nightmare Manor|Nightmare Manor|||
Nightmare Maze|Nightmare Maze|||
Nightmares|Nightmares|||
Night Mission Pinball|Night Mission Pinball|||
Nightraiders|Nightraiders|||
Nightshade|Nightshade|||
Nightstrike|Nightstrike|||
Night Strike!|Night Strike!|||
Nineball|Nineball|||
Ninja Commando|Ninja Commando|||
Ninja|Ninja|||
Nominoes Jigsaw|Nominoes Jigsaw|||
North Atlantic Convoy Raider|North Atlantic Convoy Raider|||
Nostradamus|Nostradamus|||
Nuclear Adventure or the North Base|Nuclear Adventure or the North Base|||
Nuclear Nick|Nuclear Nick|||
Nucleus|Nucleus|||
Nuke Sub & Galaxy Defender|Nuke Sub & Galaxy Defender|||
Nukewar|Nukewar|||
Number Blast|Number Blast|||
Numberland Nightwatch|Numberland Nightwatch|||
Number Stumper|Number Stumper|||
Numtris|Numtris|||
Oblitroid|Oblitroid|||
Ocean Detox|Ocean Detox|||
OCI|OCI|||
Octopus|Octopus|||
Odin|Odin|||
Ogre|Ogre|||
Oilgame Deluxe|Oilgame Deluxe|||
Oil's Well|Oil's Well|||
Ollie's Follies|Ollie's Follies|||
Olympic Skier|Olympic Skier|||
Omar|Omar|||
Omega|Omega|||
On Cue: Snooker|On Cue - Snooker|||
One Life|One Life|||
One Man and His Droid|One Man and his Droid|||
One Moon and Two Suns|One Moon and Two Suns|||
One-on-One|One-on-One|||
On-Track Computer Model Car Racing|On-Track Computer Model Car Racing|||
Opera House + Qa!|Opera House + Qa!|||
Operation Blood|Operation Blood|||
Operation Crossroads|Operation Crossroads|||
Operation Desert Storm|Operation Desert Storm|||
Operation Market Garden|Operation Market Garden|||
Operation Whirlwind|Operation Whirlwind|||
Oranges and Lemons|Oranges and Lemons|||
Orbit: A Trip to the Moon|Orbit - A Trip to the Moon|||
Orbit|Orbit|||
Orc Attack|Orc Attack|||
O'Riley's Mine|O'Riley's Mine|||
Othello|Othello|||
Other Ventures #1: Saigon the Final Days|Other Ventures #1 - Saigon the Final Days|||
Other Ventures #2: Crowley Manor|Other Ventures #2 - Crowley Manor|||
Other Ventures #3: Escape From Traam|Other Ventures #3 - Escape From Traam|||
Other Ventures #4: San Francisco 1906|Other Ventures #4 - San Francisco 1906|||
Outlaw|Outlaw|||
Outris|Outris|||
Owari|Owari|||
Ozzy's Orchard|Ozzy's Orchard|||
Pac Boulder|Pac Boulder|||
Pacific Coast Highway|Pacific Coast Highway|||
Pac-Man Arcade|Pac-Man Arcade|||
Pac-Man|Pac-Man|||
Pac Munch Jr|Pac Munch Jr|||
Paint-n-Sketch I|Paint-n-Sketch I|||
Pairs|Pairs|||
Pakmans Brothers Revenge|Pakmans Brothers Revenge|||
Pandemonium|Pandemonium|||
Pang|Pang|||
Panic Express|Panic Express|||
Panic|Panic|||
Panik!|Panik!|||
Panther|Panther|||
Panzer Grenadier|Panzer Grenadier|||
Panzer-Jagd|Panzer-Jagd|||
Paper Boy|Paper Boy|||
Parachute 2011|Parachute 2011|||
Parallax|Parallax|||
Paris in Danger|Paris in Danger|||
Parsec XL|Parsec XL|||
Party Quiz|Party Quiz|||
Pastfinder|Pastfinder|||
Pathfinder|Pathfinder|||
Patrol Nighthawk One|Patrol Nighthawk One|||
Patrol Xal Alpha|Patrol Xal Alpha|||
Paul Daniels' Magic Adventure|Paul Daniels' Magic Adventure|||
Peanut Butter Panic|Peanut Butter Panic|||
Peggammon|Peggammon|||
Pengon|Pengon|||
Pengo|Pengo|||
Pensate|Pensate|||
Periscope Up|Periscope Up|||
Perxor|Perxor|||
PET Galaga|PET Galaga|||
Phantasie II|Phantasie II|||
Phantasie|Phantasie|||
Phantom|Phantom|||
Pharaoh's Pyramid|Pharaoh's Pyramid|||
Phobos|Phobos|||
Phoenix Lair|Phoenix Lair|||
Pic.Builder|Pic.Builder|||
Picnic Paranoia|Picnic Paranoia|||
Piekielko|Piekielko|||
Pie-Man|Pie-Man|||
Pillbox|Pillbox|||
Pilot|Pilot|||
Pinball Construction Set|Pinball Construction Set|||
Pinhead|Pinhead|||
Piranha|Piranha|||
Pirate Pond|Pirate Pond|||
Pirates of the Barbary Coast|Pirates of the Barbary Coast|||
Pitfall II: Lost Caverns|Pitfall II - Lost Caverns|||
Pitfall|Pitfall|||
Pitstop II|Pitstop II|||
Pitstop|Pitstop|||
Plague Attack|Plague Attack|||
Plan B|Plan B|||
Planet Attack|Planet Attack|||
Planetfall|Planetfall|||
Planet Miners|Planet Miners|||
Planet Patrol|Planet Patrol|||
Plantation|Plantation|||
Plaque Man|Plaque Man|||
Plasma|Plasma|||
Plastron|Plastron|||
PlatterMania|Plattermania|||
Player's Dream III|Player's Dream III|||
Playful Professor Math Tutor|Playful Professor Math Tutor|||
Plot|Plot|||
Plundered Hearts|Plundered Hearts|||
Pogo Joe|Pogo Joe|||
Pogoman|Pogoman|||
Pogotron|Pogotron|||
Poker Party|Poker Party|||
PokerSAM|PokerSAM|||
Poker Tourney|Poker Tourney|||
Polar Pierre|Polar Pierre|||
Pole Position|Pole Position|||
Pondering About Max's|Pondering About Max's|||
Pongblast|Pongblast|||
Pong|Pong|||
Pontoon!|Pontoon!|||
Pool 400|Pool 400|||
Pool|Pool|||
Pooyan|Pooyan|||
Popeye|Popeye|||
Pop-n-Rocker|Pop-n-Rocker|||
Porky's|Porky's|||
Pornopoly|Pornopoly|||
Pothole Pete|Pothole Pete|||
Poussinet|Poussinet|||
Power Down|Power Down|||
Powerpath|Powerpath|||
Powerstar|Powerstar|||
P.O.W.|P.O.W.|||
Predator|Predator|||
Preppie! II|Preppie! II|||
Preppie!|Preppie!|||
Presidents of the United States|Presidents of the United States|||
Prism|Prism|||
Prisoner 2|Prisoner 2|||
Probe One: The Transmitter|Probe One - The Transmitter|||
Problem Jasia|Problem Jasia|||
Pro Bowling|Pro Bowling|||
Professor I.Q.|Professor I.Q.|||
Pro Golf|Pro Golf|||
Project Fire Blast: The Battle of Zegadon|Project Fire Blast - The Battle of Zegadon|||
Promoteur|Promoteur|||
Pro Mountain Bike Simulator|Pro Mountain Bike Simulator|||
Protector II|Protector II|||
Protector|Protector|||
Proto's Favorite Games|Proto's Favorite Games|||
Proto's Fun Day|Proto's Fun Day|||
Pungoland!|Pungoland!|||
Pushky|Pushky|||
Pushover|Pushover|||
Pushy Pig|Pushy Pig|||
Puzzle Construction Set|Puzzle Construction Set|||
Puzzle Gates of the Incas|Puzzle Gates of the Incas|||
PuzzlePanic|PuzzlePanic|||
Puzzler|Puzzler|||
Pyramidos|Pyramidos|||
Pyramid Puzzler|Pyramid Puzzler|||
Pyramid|Pyramid|||
Pyramid Run|Pyramid Run|||
Pyromania|Pyromania|||
Q-Bert|Q-Bert|||
QIX|Qix|||
QS Reversi|QS Reversi|||
Quarxon|Quarxon|||
Quasimodo|Quasimodo|||
Queen of Hearts|Queen of Hearts|||
Quest for Eternity|Quest for Eternity|||
Quest for Power|Quest for Power|||
Quest for Quintana Roo|Quest for Quintana Roo|||
Questprobe #1: The Incredible Hulk|Questprobe #1 - The Incredible Hulk|||
Questprobe #2: Spider-Man|Questprobe #2 - Spider-Man|||
Questprobe #3: Fantastic Four|Questprobe #3 - Fantastic Four|||
Questron|Questron|||
Quick Step|Quick Step|||
Quintominoes|Quintominoes|||
Quiz Master|Quiz Master|||
Rabbotz!|Rabbotz!|||
Race Car Facts|Race Car Facts|||
Race Car 'Rithmetic|Race Car 'Rithmetic|||
Race in Space|Race in Space|||
Racing Destruction Set|Racing Destruction Set|||
Rack'em Up|Rack'em Up|||
RAF: Battle of Britain|RAF - Battle of Britain|||
Raiders of Space|Raiders of Space|||
Raid on Gravitron|Raid on Gravitron|||
Raid Over Moscow|Raid over Moscow|||
Raidus!|Raidus!|||
Rails West!|Rails West!|||
Rainbow Walker|Rainbow Walker|||
Rainy Day Games|Rainy Day Games|||
Rally Speedway|Rally Speedway|||
Rampage|Rampage|||
RA|RA|||
Rasen-Maher|Rasen-Maher|||
Raster Blaster|Raster Blaster|||
Rat Race|Rat Race|||
Rats! Rats! Rats!|Rats! Rats! Rats!|||
Reader Rabbit|Reader Rabbit|||
Realm of Impossibility|Realm of Impossibility|||
RealSports Football|RealSports Football|||
RealSports Tennis|RealSports Tennis|||
Rear Guard|Rear Guard|||
Reaxion|Reaxion|||
Rebel Charge at Chickamauga|Rebel Charge at Chickamauga|||
Rebel Fighter|Rebel Fighter|||
Rebel Probe|Rebel Probe|||
Rebound|Rebound|||
Red Max|Red Max|||
Red Moon|Red Moon|||
Red Zone|Red Zone|||
Reforger '88|Reforger '88|||
Relax|Relax|||
Renaissance|Renaissance|||
Rent Wars|Rent Wars|||
Replugged|Replugged|||
Repossed|Repossed|||
Repton|Repton|||
Rescue at 94k|Rescue at 94k|||
Rescue on Fractalus!|Rescue on Fractalus!|||
Rescue|Rescue|||
Return of Heracles|Return of Heracles|||
Revenge II|Revenge II|||
Revenge of V|Revenge of V|||
Reverse|Reverse|||
Reversi II|Reversi II|||
Reversi|Reversi|||
Rhymes and Riddles|Rhymes and Riddles|||
Richard Petty's Talladega|Richard Petty's Talladega|||
Rick Hanson|Rick Hanson|||
Ricochet|Ricochet|||
Ridiculous Reality|Ridiculous Reality|||
Ringmaster|Ringmaster|||
Rings of the Empire|Rings of the Empire|||
Riot|Riot|||
Risk|Risk|||
River Raid|River Raid|||
River Rally|River Rally|||
River Rat|River Rat|||
River Rescue|River Rescue|||
Road Toad|Road Toad|||
Robal|Robal|||
Robbo 96|Robbo 96|||
Robbo 97A|Robbo 97A|||
Robbo 97B|Robbo 97B|||
Robbo 98A|Robbo 98A|||
Robbo Forever|Robbo Forever|||
Robbo III|Robbo III|||
Robbo II|Robbo II|||
Robbo IV|Robbo IV|||
Robbo Konstruktor|Robbo Konstruktor|||
Robbo|Robbo|||
Robbo V|Robbo V|||
Robinson|Robinson|||
Robin: Wojownik Czasu|Robin - Wojownik Czasu|||
Robix|Robix|||
Robomash|Robomash|||
Robot Battle|Robot Battle|||
Robot Knights|Robot Knights|||
Robotron 2084|Robotron 2084|||
Rocket Boy|Rocket Boy|||
Rocket Raiders|Rocket Raiders|||
Rocket Repairman: The Further Adventures of Cavern Commander|Rocket Repairman - The Further Adventures of Cavern Commander|||
Rocket Rescue|Rocket Rescue|||
Rocket Spell|Rocket Spell|||
Rockford|Rockford|||
Rockman|Rockman|||
Rock 'n' Rhythm|Rock 'n' Rhythm|||
Rodent Revenge|Rodent Revenge|||
Roderic|Roderic|||
Rogue|Rogue|||
Rolltris|Rolltris|||
Roman Checkers|Roman Checkers|||
Roman Empire|Roman Empire|||
Rome and the Barbarians|Rome and the Barbarians|||
Rommel: Battles for Tobruk|Rommel - Battles for Tobruk|||
Roots|Roots|||
Rosen's Brigade|Rosen's Brigade|||
Rotate|Rotate|||
R.O.T.O.|R.O.T.O.|||
Rough Rider|Rough Rider|||
Roulette Simulator|Roulette Simulator|||
Round About|Round About|||
Rubber Ball|Rubber Ball|||
Rucu|Rucu|||
Ruff and Reddy|Ruff and Reddy|||
Rum Runner|Rum Runner|||
Run for It|Run for It|||
Run for the Money|Run for the Money|||
Rush Hour|Rush Hour|||
Rycerz|Rycerz|||
Saddleman|Saddleman|||
Safe|Safe|||
SAGA No. 01: Adventureland|SAGA No. 01 - Adventureland|||
SAGA No. 02: Pirate Adventure|SAGA No. 02 - Pirate Adventure|||
SAGA No. 03: Mission Impossible|SAGA No. 03 - Mission Impossible|||
SAGA No. 04: Voodoo Castle|SAGA No. 04 - Voodoo Castle|||
SAGA No. 05: The Count|SAGA No. 05 - The Count|||
SAGA No. 06: Strange Odyssey|SAGA No. 06 - Strange Odyssey|||
SAGA No. 13: The Sorcerer of Claymorgue Castle|SAGA No. 13 - The Sorcerer of Claymorgue Castle|||
Saigon: The Final Days|Saigon - The Final Days|||
Salmon Run|Salmon Run|||
Sammy the Sea Serpent|Sammy the Sea Serpent|||
Samobojcy|Samobojcy|||
Samurai's Game|Samurai's Game|||
Sands of Mars|Sands of Mars|||
Santa's Boulder Dash Party|Santa's Boulder Dash Party|||
Saper|Saper|||
Saracen|Saracen|||
Saratoga|Saratoga|||
Sargon III|Sargon III|||
Sargon II|Sargon II|||
Satalite C|Satalite C|||
Satan's Hollow|Satan's Hollow|||
Saucer|Saucer|||
Savage Pond|Savage Pond|||
Sawfish Software Public Domain #1|Sawfish Software Public Domain #1|||
Schooner|Schooner|||
Schreckenstein|Schreckenstein|||
Scooter|Scooter|||
Scorpions|Scorpions|||
SCRAM|SCRAM|||
Screaming Wings|Screaming Wings|||
Screwball|Screwball|||
Sea Bandit|Sea Bandit|||
Sea Chase|Sea Chase|||
Sea Dragon|Sea Dragon|||
Sea Fighter|Sea Fighter|||
Seafox|Seafox|||
Sea Horse Hide'n Seek|Sea Horse Hide'n Seek|||
Seaquest|Seaquest|||
Seastalker|Seastalker|||
Seawolf II|Seawolf II|||
Secret Diary of Adrian Mole, The: Part 1|Secret Diary of Adrian Mole, The - Part 1|||
Secret Diary of Adrian Mole, The: Part 2|Secret Diary of Adrian Mole, The - Part 2|||
Secret Diary of Adrian Mole, The: Part 3|Secret Diary of Adrian Mole, The - Part 3|||
Secret Diary of Adrian Mole, The: Part 4|Secret Diary of Adrian Mole, The - Part 4|||
See-Saw Scramble|See-Saw Scramble|||
Seeschlacht|Seeschlacht|||
Sendy Dash: Volume 1|Sendy Dash - Volume 1|||
Sendy Dash: Volume 2|Sendy Dash - Volume 2|||
Sendy Dash: Volume 3|Sendy Dash - Volume 3|||
Senorita|Senorita|||
Sentinel One|Sentinel One|||
Sentinel|Sentinel|||
Serpentine|Serpentine|||
Sesame Street Letter-Go-Round|Sesame Street Letter-Go-Round|||
Seven Card Stud|Seven Card Stud|||
Seven Cities of Gold|Seven Cities of Gold|||
Sevens|Sevens|||
Sexversi|SexVersi|||
Sexy Six|Sexy Six|||
Shadow Hawk One|Shadow Hawk One|||
Shadow World|Shadow World|||
Shaft Raider|Shaft Raider|||
Shamus: Case II|Shamus - Case II|||
Shamus|Shamus|||
Shanghai|Shanghai|||
Shatablast|Shatablast|||
Shiloh 1862|Shiloh 1862|||
Shiloh: Grant's Trial in the West|Shiloh - Grant's Trial in the West|||
Ship of Stars|Ship of Stars|||
Ship|Ship|||
Shit|Shit|||
Shoot'em Up!|Shoot'em Up!|||
Shooting Arcade|Shooting Arcade|||
Shooting Gallery|Shooting Gallery|||
Shootout at the OK Galaxy|Shootout at the OK Galaxy|||
Shoot-Out|Shoot-Out|||
Showdown Hockey!|Showdown Hockey!|||
Shuffleboard|Shuffleboard|||
Shuffler|Shuffler|||
Shuttle Intercept|Shuttle Intercept|||
Sidewinder II|Sidewinder II|||
Sidewinder|Sidewinder|||
Silent Service|Silent Service|||
Silicon Dreams|Silicon Dreams|||
Silicon|Silicon|||
Silicon Warrior|Silicon Warrior|||
Silly Planter|Silly Planter|||
Simple Minds|Simple Minds|||
Sinistar|Sinistar|||
Sisyphos|Sisyphos|||
Six-Gun Shootout|Six-Gun Shootout|||
Skarbnik|Skarbnik|||
Skateboard|Skateboard|||
Ski Construction Set|Ski Construction Set|||
Skiing|Skiing|||
Ski-Weltcup|Ski-Weltcup|||
Sky Blazer|Sky Blazer|||
Sky Scraper|Sky Scraper|||
Sky Writer|Sky Writer|||
Sleazy Adventure|Sleazy Adventure|||
Sleepwalker|Sleepwalker|||
Slime|Slime|||
Slingshot|Slingshot|||
Slinky!|Slinky!|||
Slot-Machine|Slot-Machine|||
Slot Trivia|Slot Trivia|||
Smack-Jack|Smack-Jack|||
Smack|Smack|||
Smasher|Smasher|||
Smurf Hunting|Smurf Hunting|||
Smus|Smus|||
Snake Byte|Snake Byte|||
Snake-o-Nyms|Snake-o-Nyms|||
Snake Pit|Snake Pit|||
Snap II|Snap II|||
Snark Hunt|Snark Hunt|||
Sneakers|Sneakers|||
Snokie|Snokie|||
Snooker|Snooker|||
Snooper Troops: Disappearing Dolphin|Snooper Troops - Disappearing Dolphin|||
Snooper Troops: Granite Point Ghost|Snooper Troops - Granite Point Ghost|||
Snowball|Snowball|||
Soccer|Soccer|||
Softporn Adventure|Softporn Adventure|||
SoftSide Adventure No. 10: James Brand|SoftSide Adventure No. 10 - James Brand|||
SoftSide Adventure No. 13: Arrow One|SoftSide Adventure No. 13 - Arrow One|||
SoftSide Adventure No. 14: Robin Hood|SoftSide Adventure No. 14 - Robin Hood|||
SoftSide Adventure No. 15: The Mouse That Ate Chicago|SoftSide Adventure No. 15 - The Mouse That Ate Chicago|||
SoftSide Adventure No. 17: The Deadly Game|SoftSide Adventure No. 17 - The Deadly Game|||
SoftSide Adventure No. 1: Arabian Adventure|SoftSide Adventure No. 1 - Arabian Adventure|||
SoftSide Adventure No. 4: Jack the Ripper|SoftSide Adventure No. 4 - Jack the Ripper|||
SoftSide Adventure No. 5: Crime Adventure|SoftSide Adventure No. 5 - Crime Adventure|||
Solar Star|Solar Star|||
Solar System, The & Mount Saint Helens|Solar System, The & Mount Saint Helens|||
Solitaire|Solitaire|||
Solo Flight: Second Edition|Solo Flight - Second Edition|||
Solo Flight|Solo Flight|||
Sonic Death|Sonic Death|||
Sons of Liberty|Sons of Liberty|||
Sop|Sop|||
Sorcerer|Sorcerer|||
SOS Saturn|SOS Saturn|||
Space Ace|Space Ace|||
Space Arena|Space Arena|||
Spaceball|Spaceball|||
Space Blaster|Space Blaster|||
Space Bowl|Space Bowl|||
Space Chase|Space Chase|||
Space Conflict II|Space Conflict II|||
Space Conflict|Space Conflict|||
Space Cowboy|Space Cowboy|||
Space Eggs|Space Eggs|||
Space Games|Space Games|||
Space Gunner|Space Gunner|||
Space Harrier|Space Harrier|||
Space Hawk|Space Hawk|||
Space Invaders|Space Invaders|||
Space Knights|Space Knights|||
Space Lobsters|Space Lobsters|||
Space Pirates 3000|Space Pirates 3000|||
Space Rider|Space Rider|||
Space Shuttle: A Journey into Space|Space Shuttle - A Journey into Space|||
Space Shuttle: Module I|Space Shuttle - Module I|||
Space Shuttle|Space Shuttle|||
Space Station Quest|Space Station Quest|||
Space Station Zulu|Space Station Zulu|||
Space Trap|Space Trap|||
Space Trek|Space Trek|||
Space War|Space War|||
Space Wars|Space Wars|||
Space Waste Race|Space Waste Race|||
Spare Change|Spare Change|||
Spark Bugs|Spark Bugs|||
Special Delivery|Special Delivery|||
Special Forces: Operation Blood II|Special Forces - Operation Blood II|||
Spectipede|Spectipede|||
Speed Ace|Speed Ace|||
Speed Fox|Speed Fox|||
Speed Hawk|Speed Hawk|||
Speed King|Speed King|||
Speed Run|Speed Run|||
Speed Up!: Gold Edition|Speed Up! - Gold Edition|||
Speed Up!|Speed Up!|||
Speedway Blast|Speedway Blast|||
Speed Zone|Speed Zone|||
Spellbound|Spellbound|||
Spellbreaker|Spellbreaker|||
Spelldiver|Spelldiver|||
Spellicopter|Spellicopter|||
Spelling Bee Games|Spelling Bee Games|||
Spelling Genie|Spelling Genie|||
Spelunker|Spelunker|||
Spider City|Spider City|||
Spider Invasion|Spider Invasion|||
Spider Quake|Spider Quake|||
Spiky Harold|Spiky Harold|||
Spindizzy|Spindizzy|||
Spite & Malice|Spite & Malice|||
Spitfire 40|Spitfire 40|||
Spitfire Ace|Spitfire Ace|||
Spooky Castle|Spooky Castle|||
Sports Spectacular|Sports Spectacular|||
Springer|Springer|||
Sprong: The Quest For The Golden Pogostick|Sprong - The Quest For The Golden Pogostick|||
Spy Hunter|Spy Hunter|||
Spy Master|Spy Master|||
Spy's Demise|Spy's Demise|||
Spy vs Spy: Arctic Antics|Spy vs Spy - Arctic Antics|||
Spy vs Spy|Spy vs Spy|||
Spy vs Spy: The Island Caper|Spy vs Spy - The Island Caper|||
Sqoid|Sqoid|||
Square Pairs|Square Pairs|||
Squish'em|Squish'em|||
SS Achilles|SS Achilles|||
Stack Up|Stack Up|||
Starball|Starball|||
Starbase Fighter|Starbase Fighter|||
Starbase Hyperion|Starbase Hyperion|||
Starblade|Starblade|||
Starbowl Football|Starbowl Football|||
Starcross|Starcross|||
Star Crystals|Star Crystals|||
Stardust|Stardust|||
Star Fights|Star Fights|||
Starfire|Starfire|||
Starfire Warrior|Starfire Warrior|||
Star Fleet I: The War Begins!|Star Fleet I - The War Begins!|||
Star Flite|Star Flite|||
Stargate Courier|Stargate Courier|||
Stargate|Stargate|||
Starion|Starion|||
Star Island|Star Island|||
Star League Baseball|Star League Baseball|||
Star Lords|Star Lords|||
Star Maze|Star Maze|||
Starquake|Starquake|||
StarQuest: Rescue at Rigel|Starquest - Rescue at Rigel|||
StarQuest: Star Warrior|Starquest - Star Warrior|||
Star Raiders II|Star Raiders II|||
Star Raiders|Star Raiders|||
Star Sentry|Star Sentry|||
Starship Duel|Starship Duel|||
Star Trek III|Star Trek III|||
Star Trek|Star Trek|||
Star Trux|Star Trux|||
Star Voyage 1 & Star Voyage 2|Star Voyage 1 & Star Voyage 2|||
Starware|Starware|||
Star Wars: Return of the Jedi: Death Star Battle|Star Wars - Return of the Jedi - Death Star Battle|||
Star Wars|Star Wars|||
Star Wars: The Arcade Game|Star Wars - The Arcade Game|||
Star Wars: The Empire Strikes Back|Star Wars - The Empire Strikes Back|||
States and Capitals|States and Capitals|||
Static|Static|||
Stationfall|Stationfall|||
Stealth|Stealth|||
Steeple Jack|Steeple Jack|||
Stellar Conflict|Stellar Conflict|||
Stellar Shuttle|Stellar Shuttle|||
Steve Davis Snooker|Steve Davis Snooker|||
Stickybear ABC|Stickybear ABC|||
Stickybear Basket Bounce|Stickybear Basket Bounce|||
Stickybear Bop|Stickybear Bop|||
Stickybear Numbers|Stickybear Numbers|||
Stickybear Opposites|Stickybear Opposites|||
Stickybear Shapes|Stickybear Shapes|||
Stock Market|Stock Market|||
Stock Market: The Game|Stock Market - The Game|||
Stonequest|Stonequest|||
Storm|Storm|||
Stranded|Stranded|||
Stratego|Stratego|||
Strategy Pack II|Strategy Pack II|||
Strategy Pack I|Strategy Pack I|||
Strategy Simulations|Strategy Simulations|||
Stratosphere: Excelsor II|Stratosphere - Excelsor II|||
Stratos|Stratos|||
Street Attack|Street Attack|||
Streets|Streets|||
Strip Poker|Strip Poker|||
Strzelanina|Strzelanina|||
Stud Poker|Stud Poker|||
Stun Trap|Stun Trap|||
Submarine Commander|Submarine Commander|||
Submission|Submission|||
Sudoku|Sudoku|||
Sudoku Sweep|Sudoku Sweep|||
Sultan's Palace|Sultan's Palace|||
Summer Games|Summer Games|||
Sunday Golf|Sunday Golf|||
Sun Star|Sun Star|||
Suomi World Cup '91|Suomi World Cup '91|||
Super Breakout|Super Breakout|||
Super Bunny|Super Bunny|||
Super Cobra|Super Cobra|||
Super Cubes|Super Cubes|||
Super Huey|Super Huey|||
Superman III|Superman III|||
Superman: The Game|Superman - The Game|||
Super Pac-Man|Super Pac-Man|||
Super Rover|Super Rover|||
Superski|Superski|||
Super Snake|Super Snake|||
Super Soccer|Super Soccer|||
Super Stud Poker|Super Stud Poker|||
Super Yahtsee|Super Yahtsee|||
Super Zaxxon|Super Zaxxon|||
Surf's Up|Surf's Up|||
Surrender at Stalingrad|Surrender at Stalingrad|||
Survival Adventure|Survival Adventure|||
Survival of the Fittest|Survival of the Fittest|||
Survivors|Survivors|||
Survivor|Survivor|||
Suspect|Suspect|||
Suspended|Suspended|||
Swamp Chomp|Swamp Chomp|||
Swede 1|Swede 1|||
Syn Boga Wiatru|Syn Boga Wiatru|||
System 8|System 8|||
T34: The Battle|T34 - The Battle|||
Table Football|Table Football|||
TAC: Tactical Armor Command|TAC - Tactical Armor Command|||
Tactic|Tactic|||
Tactrek|Tactrek|||
Tagalon|Tagalon|||
Taipei XL 1.1|Taipei XL 1.1|||
Tales of Dragons & Cavemen|Tales of Dragons & Cavemen|||
Tanium|Tanium|||
Tank Arkade|Tank Arkade|||
Tank Commander|Tank Commander|||
Tanks|Tanks|||
Tanktics|Tanktics|||
Tank Trap|Tank Trap|||
Tank vs Tank|Tank vs Tank|||
Tapper|Tapper|||
Target Practice|Target Practice|||
Targets: A Number Game|Targets - A Number Game|||
Tari Trek|Tari Trek|||
Tarkus and the Crystal of Fear|Tarkus and the Crystal of Fear|||
Tarkus and the Orbs of Doom|Tarkus and the Orbs of Doom|||
Tarot Card|Tarot Card|||
Tarzan of the Apes|Tarzan of the Apes|||
Tauz & Kelb|Tauz & Kelb|||
Tawerna|Tawerna|||
Tax Dodge|Tax Dodge|||
Taxicab Hill|Taxicab Hill|||
Teasers by Tobbs|Teasers by Tobbs|||
Technoid|Technoid|||
Technus: Technologic Soldier|Technus - Technologic Soldier|||
Tech|Tech|||
Tecno-Ninja|Tecno-Ninja|||
Tekblast|Tekblast|||
Telengard|Telengard|||
Tell|Tell|||
Tempest Xtreem|Tempest Xtreem|||
Temple of Darkness|Temple of Darkness|||
Test Drive|Test Drive|||
Tetrad|Tetrad|||
Tetris 3D|Tetris 3D|||
Tetris|Tetris|||
T.G.I.F.|T.G.I.F.|||
TGIF|TGIF|||
The Adventurer|Adventurer, The|||
The Adventures of Buckaroo Banzai|Adventures of Buckaroo Banzai, The|||
The Adventures of Robin Hood|Adventures of Robin Hood, The|||
The Amulet|Amulet, The|||
The Arcade Machine|Arcade Machine, The|||
The Archers|Archers, The|||
The Asylum|Asylum, The|||
The Atomix Plus|Atomix Plus, The|||
Theatre Europe|Theatre Europe|||
The Battle of Chickamauga|Battle of Chickamauga, The|||
The Battle of Shiloh|Battle of Shiloh, The|||
The Bean Machine|Bean Machine, The|||
The Bewitch Castle|Bewitch Castle, The|||
The Black Forest|Black Forest, The|||
The Blade of Blackpoole|Blade of Blackpoole, The|||
The Brundles|Brundles, The|||
The Casten Game Disk|Casten Game Disk, The|||
The Castle|Castle, The|||
The Chessmaster 2000|Chessmaster 2000, The|||
The Citadel|Citadel, The|||
The Comet Game|Comet Game, The|||
The Convicts|Convicts, The|||
The Crypt|Crypt, The|||
The Curse|Curse, The|||
The Dallas Quest|Dallas Quest, The|||
The Designer's Pencil|Designer's Pencil, The|||
The Domain of the Undead|Domain of the Undead, The|||
The Dragonriders of Pern|Dragonriders of Pern, The|||
The Dragon's Eye|Dragon's Eye, The|||
The Dreadnaught Factor|Dreadnaught Factor, The|||
The Dreadnaught Factor II|The Dreadnaught Factor II|||
The E Factor|E Factor, The|||
The Eidolon|Eidolon, The|||
The Escaper|Escaper, The|||
The Eternal Dagger|Eternal Dagger, The|||
The Exterminator|Exterminator, The|||
The Extirpator!|Extirpator!, The|||
The Factory|Factory, The|||
The Fall of Rome|Fall of Rome, The|||
The Forgotten Island|Forgotten Island, The|||
The Fountain of the Gods|Fountain of the Gods, The|||
The Game of Jericho|Game of Jericho, The|||
The Gladiator|Gladiator, The|||
The Goonies|Goonies, The|||
The Great American Cross Country Road Race|Great American Cross Country Road Race, The|||
The Great Maine to California Race|Great Maine to California Race, The|||
The Growing Pains of Adrian Mole|Growing Pains of Adrian Mole, The|||
The Guild of Thieves|Guild of Thieves, The|||
The Halley Project|Halley Project, The|||
The Haunted Palace|Haunted Palace, The|||
The Hitchhiker's Guide to the Galaxy|Hitchhiker's Guide to the Galaxy, The|||
The Hunt|Hunt, The|||
The Institute|Institute, The|||
The Jet Action|Jet Action, The|||
The Jewels of Darkness Trilogy|Jewels of Darkness Trilogy, The|||
The Labyrinth of Crete|Labyrinth of Crete, The|||
The Laser Robot|Laser Robot, The|||
The Last Guardian|Last Guardian, The|||
The Last V8|Last V8, The|||
The Living Daylights|Living Daylights, The|||
The Lone Raider|Lone Raider, The|||
The Lurking Horror|Lurking Horror, The|||
The Magic Melody Box|Magic Melody Box, The|||
The Market Place|Market Place, The|||
The Mask of the Sun|Mask of the Sun, The|||
The Maze of Death|Maze of Death, The|||
The Midas Touch|Midas Touch, The|||
The Minotaur|Minotaur, The|||
The Mysterious Adventure #01: Golden Baton|Mysterious Adventure #01 - Golden Baton, The|||
The Mysterious Adventure #08: Wizard of Akyrz|Mysterious Adventure #08 - Wizard of Akyrz, The|||
The Nelson Football League|Nelson Football League, The|||
The Neverending Story|Neverending Story, The|||
The Ninja Master|Ninja Master, The|||
The Orb of Zarramier|Orb of Zarramier, The|||
The Paradise Threat|Paradise Threat, The|||
The Pawn|Pawn, The|||
The Pay-Off|Pay-Off, The|||
The Pharaoh's Curse|Pharaoh's Curse, The|||
The Pond|Pond, The|||
The Price of Magik|Price of Magik, The|||
The Princess and the Frog|Princess and the Frog, The|||
The Puzzler|Puzzler, The|||
The Quest for the Maltese Chicken|Quest for the Maltese Chicken, The|||
The Quest of the Space Beagle|Quest of the Space Beagle, The|||
The Quest|Quest, The|||
The Sands of Egypt|Sands of Egypt, The|||
The Scrolls of Abadon|Scrolls of Abadon, The|||
The Search|Search, The|||
The Serpent's Star|Serpent's Star, The|||
The Shattered Alliance|Shattered Alliance, The|||
The Slave|Slave, The|||
The Snapper|Snapper, The|||
The Spy Strikes Back|Spy Strikes Back, The|||
The Star Trek Adventure|Star Trek Adventure, The|||
The Stone of Sisyphus|Stone of Sisyphus, The|||
The Tail of Beta Lyrae|Tail of Beta Lyrae, The|||
The Temple of Apshai Trilogy|Temple of Apshai Trilogy, The|||
The Terminator|Terminator, The|||
Thetris|Thetris|||
The Trivia Arcade|Trivia Arcade, The|||
The Underworld II|Underworld II, The|||
The Underworld|Underworld, The|||
The Valley|Valley, The|||
The Vaults of Zurich|Vaults of Zurich, The|||
The War of the Worlds|War of the Worlds, The|||
The Warsaw Tetris|Warsaw Tetris, The|||
The White Barrows|White Barrows, The|||
The Witness|Witness, The|||
The Wizard of Id's WizType|Wizard of Id's WizType, The|||
Thinker|Thinker|||
Thrax Lair|Thrax Lair|||
Three Holiday Games|Three Holiday Games|||
Threshold|Threshold|||
Thrust|Thrust|||
Thunderbombs|Thunderbombs|||
Thunderfox|Thunderfox|||
Thunder Island|Thunder Island|||
Tic-Tac-Toe Facts|Tic-Tac-Toe Facts|||
Tic-Tac-Toe Spell|Tic-Tac-Toe Spell|||
Tiger Attack|Tiger Attack|||
Tiger Hunters|Tiger Hunters|||
Tigers in the Snow|Tigers in the Snow|||
Tigris|Tigris|||
Tilt|Tilt|||
Time Bandit|Time Bandit|||
Time Bomb|Time Bomb|||
Timebound|Timebound|||
Time Runner|Time Runner|||
Timeslip|Timeslip|||
Time Warp|Time Warp|||
Timezone|Timezone|||
Titan|Titan|||
Toboggan Run|Toboggan Run|||
Tobot: Part II|Tobot - Part II|||
Tomahawk|Tomahawk|||
Top Gunner Collection|Top Gunner Collection|||
Topkapi|Topkapi|||
Topper|Topper|||
Top Secret|Top Secret|||
Touchdown Football|Touchdown Football|||
Tower of Flames|Tower of Flames|||
Tower Toppler|Tower Toppler|||
Track Attack|Track Attack|||
Track & Field|Track & Field|||
Tractor Beam|Tractor Beam|||
Trailblazer|Trailblazer|||
Train Dispatcher|Train Dispatcher|||
Trains|Trains|||
Transmuter|Transmuter|||
Transylvania|Transylvania|||
Treasure Quest|Treasure Quest|||
Tree Surgeon|Tree Surgeon|||
Trekkie|Trekkie|||
Triad|Triad|||
Trial by Fire!|Trial by Fire!|||
Tricky Tracks|Tricky Tracks|||
Trion: In 3 Dimensions|Trion - In 3 Dimensions|||
Trip to Jupiter|Trip to Jupiter|||
Trisz Divinis|Trisz Divinis|||
Triumph|Triumph|||
Trivial Pursuit: Atari Genus-Edition|Trivial Pursuit - Atari Genus-Edition|||
Trivia Quest|Trivia Quest|||
Trivia Quiz|Trivia Quiz|||
Trivia Trek|Trivia Trek|||
Trivia Unlimited|Trivia Unlimited|||
Trix|Trix|||
Trolls and Tribulations|Trolls and Tribulations|||
Troll's Tale|Troll's Tale|||
Tron: The Race|Tron - The Race|||
Tron|Tron|||
Trucker|Trucker|||
Trull|Trull|||
Trust|Trust|||
TT Racer|TT Racer|||
Tube Baddies|Tube Baddies|||
Tumble Bugs|Tumble Bugs|||
Turbican|Turbican|||
Turboflex|Turboflex|||
Turf-Form|Turf-Form|||
Turmoil|Turmoil|||
Tusker|Tusker|||
Tutankham|Tutankham|||
Tutti Frutti|Tutti Frutti|||
Tutunkhamun|Tutunkhamun|||
Twerps|Twerps|||
Twilight World|Twilight World|||
Twin Pack: Sinker & Teaser|Twin Pack - Sinker & Teaser|||
Twirlybird|Twirlybird|||
Tycoon|Tycoon|||
Type Attack|Type Attack|||
Typing Tutor & Word Invaders|Typing Tutor & Word Invaders|||
Typo Attack|Typo Attack|||
Typo|Typo|||
U235|U235|||
Uczen Czarnoksieznika|Uczen Czarnoksieznika|||
Ultima III: Exodus|Ultima III - Exodus|||
Ultima II: Revenge of the Enchantress|Ultima II - Revenge of the Enchantress|||
Ultima IV: Quest of the Avatar|Ultima IV - Quest of the Avatar|||
Ultima|Ultima|||
Unicum|Unicum|||
United States Adventure|United States Adventure|||
Universal Hero|Universal Hero|||
Universe|Universe|||
Up for Grabs|Up for Grabs|||
Upior|Upior|||
Up'n Down|Up'n Down|||
Up Up and Away|Up Up and Away|||
Upward|Upward|||
Uridium|Uridium|||
U.S.A.A.F.|U.S.A.A.F.|||
Valley of the Kings|Valley of the Kings|||
Vanguard|Vanguard|||
V.C.: Vietcong|V.C. - Vietcong|||
Vegas Jackpot|Vegas Jackpot|||
Vegas Poker|Vegas Poker|||
Vengeance|Vengeance|||
Venus Voyager 2|Venus Voyager 2|||
Vicky|Vicky|||
Video Classics|Video Classics|||
Video Easel|Video Easel|||
Video Poker & Vegas Jackpot|Video Poker & Vegas Jackpot|||
Video Vegas|Video Vegas|||
Video Yahtze|Video Yahtze|||
Viper|Viper|||
Visualizer Jigsaw Game|Visualizer Jigsaw Game|||
Volleyball|Volleyball|||
Vorrak|Vorrak|||
Voyage in Time|Voyage in Time|||
Voyager I|Voyager I|||
Voyage to Home|Voyage to Home|||
Vulcano|Vulcano|||
Wall Street Challenge|Wall Street Challenge|||
WallWar|WallWar|||
Walt Disney's Alice in Wonderland|Walt Disney's Alice in Wonderland|||
War-Copter|War-Copter|||
Wargame Construction Set|Wargame Construction Set|||
WarGames|WarGames|||
Wargle!|Wargle!|||
Warhawk|Warhawk|||
War in Russia|War in Russia|||
Warlock's Revenge|Warlock's Revenge|||
Warlok|Warlok|||
Warp Zone|Warp Zone|||
Warrior of RAS Vol 1: Dunzhin|Warrior of RAS Vol 1 - Dunzhin|||
Warrior of RAS Vol 2: Kaiv|Warrior of RAS Vol 2 - Kaiv|||
Warrior of RAS Vol 3: The Wylde|Warrior of RAS Vol 3 - The Wylde|||
Warrior of RAS Vol 4: Ziggurat|Warrior of RAS Vol 4 - Ziggurat|||
Warsaw Robbo II|Warsaw Robbo II|||
Warsaw Robbo|Warsaw Robbo|||
Warships|Warships|||
Warship|Warship|||
War|War|||
Water Eat 01|Water Eat 01|||
Waterloo II|Waterloo II|||
Water Ski School|Water Ski School|||
Wavy Navy|Wavy Navy|||
Wayout|Wayout|||
Weakon|Weakon|||
Webster: The Word Game|Webster - The Word Game|||
Weihnachtsspiel|Weihnachtsspiel|||
Werner Flaschbier|Werner Flaschbier|||
What's Different|What's Different|||
Wheeler Dealers|Wheeler Dealers|||
Wheel of Fortune|Wheel of Fortune|||
Whirlinurd|Whirlinurd|||
Whistler's Brother|Whistler's Brother|||
Whiz Kid|Whiz Kid|||
Who Dares Wins II|Who Dares Wins II|||
Whomper Stomper|Whomper Stomper|||
Winged Samurai|Winged Samurai|||
Wingman|Wingman|||
Wing Wars|Wing Wars|||
Winter Challenge|Winter Challenge|||
Winter Events|Winter Events|||
Winter Olympiad 88|Winter Olympiad 88|||
Winter Olympics|Winter Olympics|||
Winter Wally|Winter Wally|||
Wishbringer|Wishbringer|||
Wizard of Wor|Wizard of Wor|||
Wizards and Dragons|Wizards and Dragons|||
Wizard's Crown|Wizard's Crown|||
Wizard's Gold|Wizard's Gold|||
Wizard's Revenge|Wizard's Revenge|||
Wizard|Wizard|||
Wladcy Ciemnosci|Wladcy Ciemnosci|||
Wloczykij|Wloczykij|||
Wombats I|Wombats I|||
Word-Draw: Famous Americans|Word-Draw - Famous Americans|||
Wordfind Magic|Wordfind Magic|||
Word Flip|Word Flip|||
WordGo|WordGo|||
Word Hanger|Word Hanger|||
Wordmaker|Wordmaker|||
Word Olympics|Word Olympics|||
Word Search: Geography|Word Search - Geography|||
Word Spinner|Word Spinner|||
World: Countries and Capitals|World - Countries and Capitals|||
World Cup 1986|World Cup 1986|||
World Cup Manager|World Cup Manager|||
World Karate Championship|World Karate Championship|||
World Soccer|World Soccer|||
World War III|World War III|||
Worms|Worms|||
Worm War I|Worm War I|||
Wustoy's|Wustoy's|||
Wyzle|Wyzle|||
X-8|X-8|||
Xagon|Xagon|||
Xenon Raid|Xenon Raid|||
Xevious|Xevious|||
Xirius Defect XXL|Xirius Defect XXL|||
Xtal: Adventure in Space|Xtal - Adventure in Space|||
Yahtman|Yahtman|||
Yar's Strike|Yar's Strike|||
Yie Ar Kung Fu|Yie Ar Kung Fu|||
Yogi Bear and Friends in The Greed Monster|Yogi Bear and Friends in The Greed Monster|||
Yogi's Great Escape|Yogi's Great Escape|||
Yoomp!|Yoomp!|||
Zack|Zack|||
Zador II|Zador II|||
Zador|Zador|||
Zap-Pak: Dizzy Dice & Stratosphere|Zap-Pak - Dizzy Dice & Stratosphere|||
Zardon|Zardon|||
Zaxxon|Zaxxon|||
Zbir|Zbir|||
Zebu-Land|Zebu-Land|||
Zenji|Zenji|||
Zeppelin|Zeppelin|||
Zero War|Zero War|||
Zeus|Zeus|||
Zip Zap Zonked|Zip Zap Zonked|||
Zoltan Escape|Zoltan Escape|||
Zombies|Zombies|||
Zone Patrol|Zone Patrol|||
Zone Ranger|Zone Ranger|||
Zone X|Zone X|||
Zork III: The Dungeon Master|Zork III - The Dungeon Master|||
Zork II: The Wizard of Frobozz|Zork II - The Wizard of Frobozz|||
Zork I: The Great Underground Empire|Zork I - The Great Underground Empire|||
Zorro|Zorro|||
Zulu Warpath|Zulu Warpath|||
Zumbaja|Zumbaja|||
Zybex|Zybex|||
