20 em 1|20-em-1|20 em 1|20 em 1|
4 Pak All Action|4 Pak All Action|4 PAK All Action||
94 Super World Cup Chukku|94 Super World Cup Soccer|94 Super World Cup Soccer|'94 Syupeo Weoldeu Keop Chukku|
Ace of Aces|Ace of Aces|Ace of Aces|Ace of Aces|
Action Fighter|Action Fighter|Action Fighter|Action Fighter|
Aerial Assault|Aerial Assault|Aerial Assault|Aerial Assault|
After Burner|After Burner|After Burner|After Burner|
Agi Gongyong Dooly|Agigongnyong Dooly|Agigongnyong Dooly|Agigongnyong Dooly|
Air Rescue|Air Rescue|Air Rescue|Air Rescue|
Akai Koudan Zillion|Akai Koudan Zillion||Akai Koudan Zillion|
Aleste|Aleste|Aleste|Aleste|
Alex Kidd: BMX Trial|Alex Kidd - BMX Trial|Alex Kidd BMX Trial||
Alex Kidd: High-Tech World|Alex Kidd in High Tech World|Alex Kidd - High-Tech World|Alex Kidd High Tech World|
Alex Kidd in Miracle World|Alex Kidd in Miracle World|Alex Kidd in Miracle World|Alex Kidd in Miracle World|
Alex Kidd in Shinobi World|Alex Kidd in Shinobi World|Alex Kidd in Shinobi World|Alex Kidd in Shinobi World|
Alex Kidd: The Lost Stars|Alex Kidd - The Lost Stars|Alex Kidd - The Lost Stars|Alex Kidd The Lost Stars|
ALF|ALF|||
Alf||Alf|Alf|
Alien³|Alien 3|Alien 3|Alien 3|
Alien Storm|Alien Storm|Alien Storm|Alien Storm|
Alien Syndrome|Alien Syndrome|Alien Syndrome|Alien Syndrome|
Altered Beast|Altered Beast|Altered Beast|Altered Beast|
Amazing Spider-Man vs. The Kingpin|Spider-Man vs. the Kingpin|Spider-Man vs. The Kingpin|Spider-Man vs The Kingpin|
American Baseball|American Baseball|American Baseball|American Baseball|
American Pro Football|American Pro Football|American Pro Football|American Pro Football|
Ancient Ys Vanished Omen||Ancient Ys Vanished Omen||
Andre Agassi Tennis|Andre Agassi Tennis|Andre Agassi Tennis|Andre Agassi Tennis|
Anmitsu Hime|Anmitsu Hime|Anmitsu Hime|Anmitsu Hime|
AntiISDA Warrior|||AntiISDA Warrior|
AntiISDA Warrior by Ventzislav Tzvetkov|AntiISDA Warrior by Ventzislav Tzvetkov|||
Arcade Smash Hits|Arcade Smash Hits|Arcade Smash Hits|Arcade Smash Hits|
Argos no Juujiken|Argos no Juujiken|Argos no Juujiken|Argos no Juujiken|
Ariel the Little Mermaid|Ariel - The Little Mermaid|Ariel - The Little Mermaid|Ariel The Little Mermaid|
Artillery Master 8k V0.9 by Haroldo O. Pinheiro|Artillery Master 8k V0.9 by Haroldo O. Pinheiro|||
As Aventuras da TV Colosso|As Aventuras da TV Colosso||As Aventuras da TV Colosso|
Ashura|Ashura|Ashura|Ashura|
Assault City||Assault City|Assault City|
Assault City: Light Phaser Version|Assault City - Light Phaser Version|||
Assault City: Pad Version|Assault City - Pad Version|||
Astérix and the Great Rescue|Asterix and the Great Rescue|Asterix and the Great Rescue|Asterix and the Great Rescue|
Astérix and the Secret Mission|Asterix and the Secret Mission|Asterix and the Secret Mission|Asterix and the Secret Mission|
Asterix|Asterix|Asterix||
Asterix (Europe) (En,Fr) ()||Asterix (Europe) (En,Fr) ()||
Asterix Rev 0|||Asterix Rev 0|
Asterix Rev 1|||Asterix Rev 1|
Astro Flash|Astro Flash|Astro Flash|Astro Flash|
Astro Warrior|Astro Warrior|Astro Warrior|Astro Warrior|
Ayrton Senna's Super Monaco GP 2|Ayrton Senna's Super Monaco GP II|Ayrton Senna's Super Monaco GP II|Super Monaco GP II|
Aztec Adventure: The Golden Road to Paradise|Aztec Adventure - The Golden Road to Paradise|Aztec Adventure - The Golden Road to Paradise|Aztec Adventure - Golden Road to Paradise, The|
Back to the Future 2|Back to the Future Part II|Back to the Future Part II|Back to the Future Part II|
Back to the Future 3|Back to the Future Part III|Back to the Future Part III|Back to the Future Part III|
Baku Baku Animal|Baku Baku Animals|Baku Baku Animal|Baku Baku Animal|
Bank Panic|Bank Panic|Bank Panic|Bank Panic|
Basket Ball Nightmare|Basket Ball Nightmare|Basket Ball Nightmare|Basket Ball Nightmare|
Batman Returns|Batman Returns|Batman Returns|Batman Returns|
Battle Out Run|Battle Out Run|Battle Out Run|Battle Out Run|
Battletoads in Battlemaniacs|Battlemaniacs|Battlemaniacs|Battlemaniacs|
Berlin no Kabe|||Berlin no Kabe|
Black Belt|Black Belt|Black Belt|Black Belt|
Blade Eagle 3D|Blade Eagle 3D|Blade Eagle|Blade Eagle|
Blockhead .1|||Blockhead .1|
Blockhead|||Blockhead|
Blockhead by Proppy & Tet|Blockhead by Proppy & Tet|||
Blockhead WIP1 by Proppy & Tet|Blockhead WIP1 by Proppy & Tet|||
Blockhead WIP2 by Proppy & Tet|Blockhead WIP2 by Proppy & Tet|||
BMP2Tile Demo|BMP2Tile Demo|||
BMX Trial: Alex Kidd|||BMX Trial - Alex Kidd|
Bock's Birthday 2002 by Maxim|Bock's Birthday 2002 by Maxim|||
Bock's Birthday 2003 by Maxim|Bock's Birthday 2003 by Maxim|||
Bock's Birthday 2004 by xiao|Bock's Birthday 2004 by xiao|||
Bock's Birthday 2006 by Charles MacDonald|Bock's Birthday 2006 by Charles MacDonald|||
Bomber Raid|Bomber Raid|Bomber Raid|Bomber Raid|
Bonanza Bros.|Bonanza Bros|Bonanza Bros.|Bonanza Bros.|
Bonkers: Wax Up|Bonkers Wax Up!|Bonkers Wax Up!|Bonkers Wax Up!|
Borgman|||Borgman|
Bram Stoker's Dracula|Bram Stoker's Dracula|Bram Stoker's Dracula||
Bubble Bobble|Bubble Bobble|Bubble Bobble|Bubble Bobble|
Buggy Run|Buggy Run|Buggy Run|Buggy Run|
California Games 2|California Games II|California Games II|California Games II|
California Games|California Games|California Games|California Games|
Canyon Racer V0.01alpha by Haroldo O. Pinheiro|Canyon Racer V0.01alpha by Haroldo O. Pinheiro|||
Captain Silver|Captain Silver|Captain Silver|Captain Silver|
Casino Games|Casino Games|Casino Games|Casino Games|
Castelo Rá-Tim-Bum|Castelo Ra Tin Bum|Castelo Ra-Tim-Bum|Castelo Ra-Tim-Bum|
Castle of Illusion starring Mickey Mouse|Castle of Illusion Starring Mickey Mouse|Castle of Illusion Starring Mickey Mouse|Castle of Illusion starring Mickey Mouse|
Champion Boxing|Champion Boxing|||
Championship Hockey|Championship Hockey|Championship Hockey|Championship Hockey|
Champions of Europe|Champions of Europe|Champions of Europe|Champions of Europe|
Chapolim x Drácula: Um Duelo Assustador|Chapolim x Dracula - Um Duelo Assustador|Chapolim x Dracula - Um Duelo Assustador|Chapolim x Dracula - Um Duelo Assustador|
Chase H.Q.|Taito Chase H.Q.|Taito Chase H.Q.|Chase H.Q.|
Cheese Cat-Astrophe starring Speedy Gonzales|Cheese Cat-astrophe|Cheese Cat-astrophe Starring Speedy Gonzales|Cheese Cat-astrophe starring Speedy Gonzales|
Chkstate Demo by Dave|Chkstate Demo by Dave|||
Chōonsenshi Borgman|Chouon Senshi Borgman|Chouon Senshi Borgman||
Choplifter!|Choplifter|Choplifter|Choplifter|
Chuck Rock 2: Son of Chuck|Chuck Rock II - Son of Chuck|Chuck Rock II - Son of Chuck|Chuck Rock II - Son of Chuck|
Chuck Rock|Chuck Rock|Chuck Rock|Chuck Rock|
Circuit|||Circuit, The|
Circuit||Circuit, The||
Circuit|Circuit, The|||
Cloud Master|Cloud Master|Cloud Master|Cloud Master|
Code 38: Volume I|Code 38 - Volume I|||
Color & Switch Test|Color & Switch Test|||
Color & Switch Test (Japan) ()||Color & Switch Test (Japan) ()||
Columns|Columns|Columns|Columns|
Comical Machine Gun Joe||Comical Machine Gun Joe||
Complete Arcade Pack Collection|Complete Arcade Pack Collection, The|||
Cool Spot|Cool Spot|Cool Spot|Cool Spot|
Copyright Violation by Nicolas Warren|Copyright Violation by Nicolas Warren|||
Cosmic Spacehead|Cosmic Spacehead|Cosmic Spacehead|Cosmic Spacehead|
Cyber Shinobi|Cyber Shinobi|||
Cyber Shinobi||Cyber Shinobi, The||
Cyber Shinobi: Shinobi Part 2|Alex Kidd in Shinobi World|Alex Kidd in Shinobi World|Alex Kidd in Shinobi World|
Cyber Shinobi, The: Shinobi Part 2|||Cyber Shinobi, The - Shinobi Part 2|
Cyborg Hunter|Cyborg Hunter|Cyborg Hunter|Cyborg Hunter|
Daffy Duck in Hollywood|Daffy Duck in Hollywood|Daffy Duck in Hollywood|Daffy Duck in Hollywood|
Dallyeora Pigu-Wang||Dallyeora Pigu-Wang||
Damiana|Damiana||Damiana|
Danan the Jungle Fighter|Danan the Jungle Fighter|Danan - The Jungle Fighter|Danan - Jungle Fighter, The|
DCEvolution.net Intro|DCEvolution.net Intro|||
Dead Angle|Dead Angle|Dead Angle|Dead Angle|
Deep Duck Trouble starring Donald Duck|Deep Duck Trouble|Deep Duck Trouble Starring Donald Duck|Deep Duck Trouble starring Donald Duck|
Desert Speedtrap starring Road Runner and Wile E. Coyote|Desert Speedtrap - Starring Road Runner and Wile E. Coyote|Desert Speedtrap Starring Road Runner and Wile E. Coyote|Desert Speedtrap starring Road Runner and Wile E. Coyote|
Desert Strike: Return to the Gulf|Desert Strike|Desert Strike|Desert Strike|
Dick Tracy|Dick Tracy|Dick Tracy|Dick Tracy|
Digger Chan by Aypok|Digger Chan by Aypok|||
Digger Chan|||Digger Chan|
Dinobasher starring Bignose the Caveman|||Dinobasher starring Bignose the Caveman|
Dinobasher Starring Bignose the Caveman||Dinobasher Starring Bignose the Caveman||
Dinobasher: Starring Bignose the Caveman|Dinobasher - Starring Bignose the Caveman|||
Dinosaur Dooley||Dinosaur Dooley, The||
Disney's Aladdin|Aladdin|Aladdin|Aladdin|
Dodgeball King|Dodgeball King||Dodgeball King|
Doki Doki Penguin Land: Uchuu Daibouken||Doki Doki Penguin Land - Uchuu Daibouken||
Double Dragon|Double Dragon|Double Dragon|Double Dragon|
Double Hawk|Double Hawk|Double Hawk|Double Hawk|
Double Target: Cynthia no Nemuri||Double Target - Cynthia no Nemuri||
Double Target|Double Target||Double Target|
Dracula|||Dracula|
Dragon Crystal|Dragon Crystal|Dragon Crystal|Dragon Crystal|
Dragon|||Dragon|
Dragon: The Bruce Lee Story|Dragon - The Bruce Lee Story|Dragon - The Bruce Lee Story||
Draw Poker by Mike Beaver|Draw Poker by Mike Beaver|||
Draw Poker|||Draw Poker|
Dr. Hello|||Dr. Hello|
Dr. HELLO|Dr. HELLO|||
Driar (V0.05) by fx and ejdolf|Driar (V0.05) by fx and ejdolf|||
Dr. Robotnik's Mean Bean Machine|Dr. Robotnik's Mean Bean Machine|Dr. Robotnik's Mean Bean Machine|Dr. Robotnik's Mean Bean Machine|
Dynamite Duke|Dynamite Duke|Dynamite Duke|Dynamite Duke|
Dynamite Dux|Dynamite Dux|Dynamite Dux|Dynamite Dux|
Dynamite Headdy|Dynamite Headdy|Dynamite Headdy|Dynamite Headdy|
Earthworm Jim|Earthworm Jim|Earthworm Jim|Earthworm Jim|
Ecco 2: The Tides of Time|Ecco the Dolphin - Tides of Time|Ecco - The Tides of Time|Ecco - Tides of Time, The|
Ecco|||Ecco|
Ecco the Dolphin|Ecco the Dolphin|Ecco the Dolphin||
Elite Gaiden V0.1.8 by Ricardo Bittencourt|Elite Gaiden V0.1.8 by Ricardo Bittencourt|||
Enduro Racer|Enduro Racer|Enduro Racer|Enduro Racer|
E-SWAT: City Under Siege|E-SWAT - City Under Siege|E-SWAT - City Under Siege|E-Swat - City Under Siege|
European SMS BIOS|European SMS BIOS|||
Excellent Dizzy Collection||Excellent Dizzy Collection, The||
F-16 Fighter|F-16 Fighter|F-16 Fighter|F-16 Fighter|
F-16 Fighting Falcon|F-16 Fighting Falcon|F-16 Fighting Falcon|F-16 Fighting Falcon|
F1|F1 Championship|F1|F1|
Family Games||Family Games|Family Games|
Fantastic Adventures of Dizzy|Fantastic Dizzy|Fantastic Dizzy|Fantastic Dizzy|
Fantasy Zone 2|Fantasy Zone II - The Tears of Opa-Opa|Fantasy Zone II - The Tears of Opa-Opa|Fantasy Zone - Tears of Opa-Opa, The|
Fantasy Zone|Fantasy Zone|Fantasy Zone|Fantasy Zone|
Fantasy Zone: The Maze|Fantasy Zone - The Maze|Fantasy Zone - The Maze|Fantasy Zone - Maze, The|
Fantasy Zone (World) ()||Fantasy Zone (World) ()||
Felipe em Acao|Felipe em Acao|||
Férias Frustradas do Pica-Pau|Ferias Frustradas do Picapau|Ferias Frustradas do Pica Pau|Ferias Frustradas do Pica-Pau|
FIFA International Soccer|FIFA International Soccer||FIFA International Soccer|
Final Bubble Bobble|Final Bubble Bobble|Final Bubble Bobble|Final Bubble Bobble|
Fire and Forget 2: The Death Convoy|Fire & Forget 2|Fire & Forget II|Fire & Forget II|
Fire and Ice|Fire & Ice|Fire & Ice|Fire & Ice|
Fire Track|||Fire Track|
Flash|||Flash, The|
Flash||Flash, The||
Flash|Flash, The|||
Flintstones|Flintstones, The|Flintstones, The|Flintstones, The|
Forgotten Worlds|Forgotten Worlds|Forgotten Worlds|Forgotten Worlds|
French Board Games|French Board Games|||
French Educational Games|French Educational Games|||
French Electricity Utils|French Electricity Utils|||
French Games 1|French Games 1|||
French Games 2|French Games 2|||
French Graphic Example Programs|French Graphic Example Programs|||
French Musique|French Musique|||
Fri For Fransk! V1.02 by Marc Klemp|Fri For Fransk! V1.02 by Marc Klemp|||
Frogger|||Frogger|
Fushigi no Oshiro Pit Pot|Fushigi no Oshiro Pit Pot|Fushigi no Oshiro Pit Pot||
Gaegujangi Ggachi||Gaegujangi Ggachi||
Gain Ground|Gain Ground|Gain Ground|Gain Ground|
Galactic Protector|Galactic Protector|Galactic Protector|Galactic Protector|
Galaxy Force|Galaxy Force|Galaxy Force|Galaxy Force|
Game Box Serie Corridas|Game Box Série Corridas|||
Game Box Série Esportes|Game Box Serie Esportes|||
Game Box Série Esportes Radicais|Game Box Esportes Radicais|Game Box Serie Esportes Radicais|Game Box Esportes Radicais|
Game Box Série Lutas|Game Box Serie Lutas|||
Gangster Town|Gangster Town|Gangster Town|Gangster Town|
Gauntlet|Gauntlet|Gauntlet|Gauntlet|
Genesis 6 Button Controller Test by Charles MacDonald|Genesis 6 Button Controller Test by Charles MacDonald|||
George Foreman's KO Boxing|George Foreman's KO Boxing|George Foreman's KO Boxing||
Geraldinho|Geraldinho|Geraldinho|Geraldinho|
Ghostbusters|Ghostbusters|Ghostbusters|Ghostbusters|
Ghost House|Ghost House|Ghost House|Ghost House|
Ghouls'n Ghosts|Ghouls 'n Ghosts|Ghouls'n Ghosts|Ghouls 'n Ghosts|
Global Defense|Global Defense|Global Defense|Global Defense|
G-Loc Air Battle|G-Loc Air Battle|G-LOC Air Battle||
G-Loc Air Battle: Loss of Consciousness by G-Force|||G-Loc Air Battle - Loss of Consciousness by G-Force|
Gokuaku Doumei Dump Matsumoto|Gokuaku Doumei Dump Matsumoto|Gokuaku Doumei Dump Matsumoto|Gokuaku Doumei Dump Matsumoto|
Golden Axe|Golden Axe|Golden Axe|Golden Axe|
Golden Axe Warrior|Golden Axe Warrior|Golden Axe Warrior|Golden Axe Warrior|
Golfamania||Golfamania|Golfamania|
Golf Mania|Golf Mania|||
Golvellius||Golvellius|Golvellius|
Golvellius: Valley of Doom|Golvellius - Valley of Doom|||
GoodAdvice by Nicolas Warren|GoodAdvice by Nicolas Warren|||
GP Rider|GP Rider|GP Rider|GP Rider|
Great Baseball|Great Baseball|Great Baseball|Great Baseball|
Great Basketball|Great Basketball|Great Basketball|Great Basketball|
Great Football|Great Football|Great Football|Great Football|
Great Golf|Great Golf|Great Golf|Great Golf|
Great Ice Hockey|Great Ice Hockey|Great Ice Hockey|Great Ice Hockey|
Great Soccer|Great Soccer|Great Soccer|Great Soccer|
Great Tennis||Great Tennis||
Great Volleyball|Great Volleyball|Great Volleyball|Great Volley Ball|
Guerreiro Lobo V2.0|Guerreiro Lobo V2.0|||
Guzzler|Guzzler|||
Haja no Fuuin|Haja no Fuuin|Haja no Fuuin|Haja no Fuuin|
Hang-On & Astro Warrior|Hang-On & Astro Warrior|Hang-On & Astro Warrior|Hang-On + Astro Warrior|
Hang-On|Hang-On|Hang-On|Hang-On|
Hang On & Safari Hunt: The Combo Cartridge|Hang-On & Safari Hunt|Hang-On & Safari Hunt|Hang-On + Safari Hunt|
Happy Looser by Zoop|Happy Looser by Zoop|||
Headbreak For A Scroller|Headbreak For A Scroller|||
Heavyweight Champ|Heavyweight Champ|Heavyweight Champ|Heavyweight Champ|
Hello, World Test 1|Hello, World Test 1|||
Heroes of the Lance|Heroes of the Lance|Heroes of the Lance|Heroes of the Lance|
High School Kimengumi|||High School Kimengumi|
High School! Kimengumi|High School! Kimengumi|High School! Kimengumi||
Hokuto no Ken|Hokuto no Ken|Hokuto no Ken|Hokuto no Ken|
Home Alone|Home Alone|Home Alone|Home Alone|
Hook|Hook|Hook|Hook|
Hoshi o sagashite...|Hoshi wo Sagasite...|Hoshi wo Sagasite...|Hoshi wo Sagashite|
Impossible Mission|Impossible Mission|Impossible Mission|Impossible Mission|
Incredible Crash Dummies|Incredible Crash Dummies, The|Incredible Crash Dummies, The|Incredible Crash Dummies, The|
Incredible Hulk|||Incredible Hulk, The|
Incredible Hulk||Incredible Hulk, The||
Incredible Hulk|Incredible Hulk, The|||
Indiana Jones and the Last Crusade: The Action Game|Indiana Jones and the Last Crusade|Indiana Jones and the Last Crusade|Indiana Jones and the Last Crusade|
Interactive Sprite Test|Interactive Sprite Test|||
Interrupt Test|Interrupt Test|||
Ironman Ivan Stewart's Super Off-Road|Super Off-Road|Super Off Road|Super Off Road|
James Bond 007: The Duel|James Bond 007 - The Duel|James Bond 007 - The Duel|James Bond 007 - Duel, The|
James 'Buster' Douglas Knockout Boxing|James 'Buster' Douglas Knockout Boxing|James 'Buster' Douglas Knockout Boxing|James Buster Douglas Knockout Boxing|
James Pond 2: Codename: RoboCod|James Pond 2 - Codename Robocod|James Pond 2 - CodeRoboCod|James Pond II - CodeRobocod|
Japanese SMS BIOS|Japanese SMS BIOS|||
Joe Montana Football|Joe Montana Football|Joe Montana Football|Joe Montana Football|
Jogos de Verao 2|Jogos de Verao II|Jogos de Verao II||
Jornada do Mymo 2|Jornada do Mymo II|||
Jornada do Mymo|Jornada do Mymo|||
Jungle Book|||Jungle Book, The|
Jungle Book||Jungle Book, The||
Jungle Book|Jungle Book, The|||
Jurassic Park|Jurassic Park|Jurassic Park|Jurassic Park|
Kamikaze|Kamikaze|||
Kenseiden|Kenseiden|Kenseiden|Kenseiden|
King's Quest|||King's Quest|
King's Quest: Quest for the Crown||King's Quest - Quest for the Crown||
King's Quest: Quest for the Crown|King's Quest - Quest for the Crown|||
Klax|Klax|Klax|Klax|
KO Boxing|||KO Boxing|
Krusty's Fun House|Krusty's Fun House|Krusty's Fun House|Krusty's Fun House|
Kujakuō|Kujaku Ou|Kujaku Ou|Kujakuou|
Kung Fu Kid|Kung Fu Kid|Kung Fu Kid|Kung Fu Kid|
KunKun and KokoKun|||KunKun and KokoKun|
KunKun & KokoKun by Bock|KunKun & KokoKun by Bock|||
Land of Illusion Starring Mickey Mouse|Land of Illusion Starring Mickey Mouse|Land of Illusion Starring Mickey Mouse|Land of Illusion starring Mickey Mouse|
Laser Ghost|Laser Ghost|Laser Ghost|Laser Ghost|
Legend of Illusion starring Mickey Mouse|Legend of Illusion Starring Mickey Mouse|Legend of Illusion Starring Mickey Mouse|Legend of Illusion starring Mickey Mouse|
Lemmings|Lemmings|Lemmings|Lemmings|
Line Interrupt Test #1 by Charles MacDonald|Line Interrupt Test #1 by Charles MacDonald|||
Line of Fire / Bakudan Yarou|Line of Fire|Line of Fire|Line of Fire|
Lion King|Lion King, The|Lion King, The|Lion King, The|
Loletta no Syouzou|Loletta no Syouzou|||
Lord of Sword||Lord of Sword|Lord of Sword|
Lord of the Sword|Lord of the Sword|Lord of the Sword|Lord of the Sword|
Loretta no Shouzou||Loretta no Shouzou|Loretta no Shouzou|
Loriciel's Z-80 Utilities Disk|Loriciel's Z-80 Utilities Disk|||
Lucky Dime Caper starring Donald Duck|Lucky Dime Caper, The - Starring Donald Duck|Lucky Dime Caper Starring Donald Duck, The|Lucky Dime Caper starring Donald Duck, The|
Machine Gun Joe|Machine Gun Joe||Machine Gun Joe|
Magali no Castelo do Dragao|Magali no Castelo do Dragao|||
Magic Drive Plus BIOS|Magic Drive Plus BIOS|||
Mahjong Sengoku Jidai|Mahjong Sengoku Jidai|Mahjong Sengoku Jidai|Mahjong Sengoku Jidai|
Makai Retsuden|Makai Retsuden|Makai Retsuden|Makai Retsuden|
Marble Madness|Marble Madness|Marble Madness|Marble Madness|
Marksman Shooting & Trap Shooting|Marksman Shooting - Trap Shooting|Marksman Shooting & Trap Shooting|Marksman Shooting + Trap Shooting|
Marksman Shooting & Trap Shooting & Safari Hunt||Marksman Shooting & Trap Shooting & Safari Hunt||
Master Mario Bros.|Master Mario Bros|||
Master Mega Man|Master Mega Man|||
Master of Darkness|Master of Darkness|Master of Darkness|Master of Darkness|
Masters Golf|||Masters Golf|
Master Smash Brothers V1.0|Master Smash Brothers V1.0|||
Masters of Combat|Masters of Combat|Masters of Combat|Masters of Combat|
Master Zelda|Master Zelda|||
Maze Hunter 3-D|Maze Hunter 3D|Maze Hunter 3-D|Maze Hunter 3D|
Maze Walker|Maze Walker|Maze Walker|Maze Walker|
Megumi Rescue|Megumi Rescue|Megumi Rescue|Megumi Rescue|
Mercs|Mercs|Mercs|Mercs|
Michael Jackson's Moonwalker|Michael Jackson's Moonwalker|Michael Jackson's Moonwalker||
Mickey's Ultimate Challenge|Mickey's Ultimate Challenge|Mickey's Ultimate Challenge|Mickey's Ultimate Challenge|
Mick & Mack as the Global Gladiators|Mick & Mack as The Global Gladiators|Mick & Mack as the Global Gladiators|Mick & Mack as The Global Gladiators|
Micro Machines|Micro Machines|Micro Machines|Micro Machines|
Miracle Warriors: Seal of the Dark Lord|Miracle Warriors - Seal of the Dark Lord|Miracle Warriors - Seal of the Dark Lord|Miracle Warriors - Seal of the Dark Lord|
Missile Defense 3-D|Missile Defense 3-D|Missile Defense 3-D|Missile Defense 3-D|
Monica 3|Monica 3|||
Mônica no Castelo do Dragão|Monica no Castelo do Dragao|Monica no Castelo do Dragao|Monica no Castelo do Dragao|
Monopoly|Monopoly|Monopoly|Monopoly|
Montezuma's Revenge|Montezuma's Revenge|Montezuma's Revenge Featuring Panama Joe|Montezuma's Revenge|
Moonwalker|||Moonwalker|
Mortal Kombat 3|Mortal Kombat 3|Mortal Kombat 3|Mortal Kombat 3|
Mortal Kombat II|Mortal Kombat 2|Mortal Kombat II|Mortal Kombat II|
Mortal Kombat|Mortal Kombat|Mortal Kombat|Mortal Kombat|
Ms. Pac-Man|Ms. Pac-man|Ms. Pac-Man|Ms. Pac-Man|
My Hero|My Hero|My Hero|My Hero|
Name|GoodName|NoIntro|TOSEC|ReDump
NanoWars 8k by Haroldo O. Pinheiro|NanoWars 8k by Haroldo O. Pinheiro|||
Natal do Mymo|Natal do Mymo|||
Nekkyuu Koushien||Nekkyuu Koushien||
Nekyuu Kousien|Nekyuu Kousien||Nekyuu Kousien|
New Zealand Story|New Zealand Story, The|New Zealand Story, The|NewZealand Story, The|
Nihonshi Ninpyou|Nihonshi Ninpyou|||
Nine Pixels by Nicolas Warren|Nine Pixels by Nicolas Warren|||
Ninja Gaiden|Ninja Gaiden|Ninja Gaiden|Ninja Gaiden|
Ninja|Ninja, The|Ninja, The|Ninja, The|
Not Only Words|Not Only Words|||
Olympiades|Olympiades|||
Olympic Gold: Barcelona '92|Olympic Gold - Barcelona '92|||
Only Words by Mike Gordon|Only Words by Mike Gordon|||
Opa Opa|Opa Opa|Opa Opa|Opa Opa|
Operation Wolf|Operation Wolf|Operation Wolf|Operation Wolf|
Ottifants|||Ottifants, The|
Ottifants||Ottifants, The||
Ottifants|Ottifants, The|||
Out Run 3-D|OutRun 3D|Out Run 3-D|Out Run 3D|
Out Run Europa|OutRun Europa|Out Run Europa|Out Run Europa|
Out Run|OutRun|Out Run|Out Run|
Pac-Mania|Pac-Mania|Pac-Mania|Pac-Mania|
Pac-Man|||Pac-Man|
Paperboy|Paperboy|Paperboy|Paperboy|
Parlour Games|Parlour Games|Parlour Games|Parlour Games|
Party Games|Party Games|||
Pat Riley Basketball|Pat Riley Basketball|Pat Riley Basketball|Pat Riley Basketball|
Paws 32K Intro by An!mal|Paws 32K Intro by An!mal|||
Penguin Land|Penguin Land|Penguin Land|Penguin Land|
PFR Detect V1.00 by Eric R. Quinn|PFR Detect V1.00 by Eric R. Quinn|||
PFR Detect V2.00 by Eric R. Quinn|PFR Detect V2.00 by Eric R. Quinn|||
PGA Tour Golf|PGA Tour Golf|PGA Tour Golf|PGA Tour Golf|
Phantasy Star|Phantasy Star|Phantasy Star|Phantasy Star|
Phantasy Star Rev 2|||Phantasy Star Rev 2|
Phantasy Star Rev 3|||Phantasy Star Rev 3|
Phantasy Star (USA, Europe) ()||Phantasy Star (USA, Europe) ()||
Photo|Photo|||
Pit Fighter|Pit Fighter|Pit Fighter|Pit Fighter|
Pit Pot & Astro Warrior: The Combo Cartridge|Astro Warrior & Pit Pot|Astro Warrior & Pit Pot|Pit Pot + Astro Warrior|
Pit Pot|||Pit Pot|
Pit Pot: The Magical Castle|Pit Pot - The Magical Castle|||
Pokemon Master V2.0|Pokemon Master V2.0|||
Pokemon Versao Amarela|Pokemon Versao Amarela|||
Pokemon Versao Azul|Pokemon Versao Azul|||
Pokemon Versao Secreta|Pokemon Versao Secreta|||
Pokemon Versao Vermelha|Pokemon Versao Vermelha|||
Pongmaster 4k by Haroldo O. Pinheiro|Pongmaster 4k by Haroldo O. Pinheiro|||
Pongmaster by Haroldo O. Pinheiro|Pongmaster by Haroldo O. Pinheiro|||
Pong Master|||Pong Master|
Pop Breaker|||Pop Breaker|
Populous|Populous|Populous|Populous|
Poseidon Wars 3-D|Poseidon Wars 3D|Poseidon Wars 3-D|Poseidon Wars 3D|
Poseidon Wars: Space Panic: Rambo|Poseidon Wars - Space Panic - Rambo|||
Power Strike 2|Power Strike 2|Power Strike II|Power Strike II|
Power Strike|Power Strike|Power Strike|Power Strike|
Predator 2|Predator 2|Predator 2|Predator 2|
Prince of Persia|Prince of Persia|Prince of Persia|Prince of Persia|
Promocao Especial M. System III Compact||Promocao Especial M. System III Compact||
Promocao Especial M.System III Compact|Promocao Especial M.System III Compact|||
Pro Wrestling|Pro Wrestling|Pro Wrestling|Pro Wrestling|
Pro Yakyuu Pennant Race|||Pro Yakyuu Pennant Race, The|
Pro Yakyuu Pennant Race||Pro Yakyuu Pennant Race, The||
Pro Yakyuu Pennant Race|Pro Yakyuu Pennant Race, The|||
Psychic World|Psychic World|Psychic World|Psychic World|
Psycho Fox|Psycho Fox|Psycho Fox|Psycho Fox|
Putt & Putter|Putt & Putter|Putt & Putter|Putt & Putter|
Q*bert|Q-bert|||
Quartet|Quartet|Quartet|Quartet|
Quest for the Shaven Yak starring Ren Hoëk & Stimpy||Quest for the Shaven Yak Starring Ren Hoek & Stimpy|Quest for the Shaven Yak starring Ren Hoek & Stimpy|
Rainbow Islands: The Story of Bubble Bobble 2|Rainbow Islands|Rainbow Islands - The Story of Bubble Bobble 2|Rainbow Islands - Story of Bubble Bobble 2, The|
Rambo: First Blood Part 2|Rambo - First Blood Part 2|Rambo - First Blood Part II||
Rambo III|Rambo III|Rambo III|Rambo III|
Rambo|||Rambo|
Rampage|Rampage|Rampage|Rampage|
Rampart|Rampart|Rampart|Rampart|
Rastan|Rastan|Rastan|Rastan|
R.C. Grand Prix|R.C. Grand Prix|R.C. Grand Prix|R.C. Grand Prix|
Reggie Jackson Baseball|Reggie Jackson Baseball|Reggie Jackson Baseball|Reggie Jackson Base-Ball|
Renegade|Renegade|Renegade|Renegade|
Ren & Stimpy: Quest for the Shaven Yak|Ren & Stimpy - Quest for the Shaven Yak, The|||
Rescue Mission|Rescue Mission|Rescue Mission|Rescue Mission|
R.H.W. 2000|R.H.W. 2000|||
Rise of the Robots|Rise of the Robots|||
River Strike V0.01alpha by Haroldo O. Pinheiro|River Strike V0.01alpha by Haroldo O. Pinheiro|||
River Strike V0.02alpha by Haroldo O. Pinheiro|River Strike V0.02alpha by Haroldo O. Pinheiro|||
River Strike V0.03alpha by Haroldo O. Pinheiro|River Strike V0.03alpha by Haroldo O. Pinheiro|||
River Strike V0.04alpha by Haroldo O. Pinheiro|River Strike V0.04alpha by Haroldo O. Pinheiro|||
Road Rash|Road Rash|Road Rash|Road Rash|
Robbyie|Robbyie||Robbyie|
Robocop 3|Robocop 3|RoboCop 3|RoboCop 3|
Robocop vs. the Terminator|Robocop versus The Terminator|RoboCop versus The Terminator|RoboCop versus The Terminator|
Rocky|Rocky|Rocky|Rocky|
Rodrigo 2 em: Mate O Leonardo|Rodrigo 2 em - Mate O Leonardo|||
Rodrigo 2 em: Mate O Papai Noel: Versao de Natal|Rodrigo 2 em - Mate O Papai Noel - Versao de Natal|||
Rodrigo O Resgate|Rodrigo O Resgate|||
R-Type|R-Type|R-Type|R-Type|
Running Battle|Running Battle|Running Battle|Running Battle|
Rygar|Rygar|||
Sagaia|Sagaia|Sagaia|Sagaia|
SALY V1.00 by Marc Klemp|SALY V1.00 by Marc Klemp|||
Sangokushi 3|Sangokushi 3|Sangokushi 3||
Sangokushi 3|||Sangokushi III|
Sapo Xulé: O Mestre do Kung Fu|Sapo Xule O Mestre do Kung Fu|Sapo Xule - O Mestre do Kung Fu|Sapo Xule O Mestre do Kung Fu|
Sapo Xulé: S.O.S. Lagoa Poluída|Sapo Xule SOS Lagoa Poluida|Sapo Xule - S.O.S Lagoa Poluida|SOS Lagoa Poluida|
Sapo Xulé vs. Os Invasores do Brejo|Sapo Xule vs. os Invasores do Brejo|Sapo Xule vs. Os Invasores do Brejo|Sapo Xule vs. Os Invasores do Brejo|
Satellite-7|||Satellite-7|
Satellite 7|Satellite 7|Satellite 7||
Schtroumpfs Autour Du Monde||Schtroumpfs Autour Du Monde, Les||
Scramble Spirits|Scramble Spirits|Scramble Spirits|Scramble Spirits|
Scroll Test Program by Charles MacDonald|Scroll Test Program by Charles MacDonald|||
SDI - Strategic Defense Initiative|SDI|SDI|S.D.I.|
Secret Commando|Secret Commando|Secret Command|Secret Commando|
Sega BASIC Level 2|Sega BASIC Level 2|||
Sega BASIC Level 3 V1|Sega BASIC Level 3 V1|||
Sega Chess|Sega Chess|Sega Chess|Sega Chess|
Sega Disk Basic|Sega Disk Basic|||
Sega Disk Basic with Yeno Demo|Sega Disk Basic with Yeno Demo|||
Sega Logo V1.0e|Sega Logo V1.0e|||
Sega Mark III BG Test|Sega Mark III BG Test|||
Sega Mark III Port Test|Sega Mark III Port Test|||
Sega Music Editor|Sega Music Editor|||
SegaSlide by FluBBa|SegaSlide by FluBBa|||
Sega Tween (3D) by Ben Ryves|Sega Tween (3D) by Ben Ryves|||
Sega Tween (Normal) by Ben Ryves|Sega Tween (Normal) by Ben Ryves|||
Sega World Tournament Golf|Sega World Tournament Golf|Sega World Tournament Golf|Sega World Tournament Golf|
Seishun Scandal||Seishun Scandal||
Seishyun Scandal|Seishyun Scandal||Seishyun Scandal|
Sensible Soccer: European Champions: 92/93 Edition|Sensible Soccer|Sensible Soccer|Sensible Soccer|
SF-7000 Initial Program Loader ROM|SF-7000 Initial Program Loader ROM|||
Shadow Dancer|Shadow Dancer|Shadow Dancer|Shadow Dancer|
Shadow of the Beast|Shadow of the Beast|Shadow of the Beast|Shadow of the Beast|
Shanghai|Shanghai|Shanghai|Shanghai|
Shinobi|Shinobi|Shinobi|Shinobi|
Shooting Gallery|Shooting Gallery|Shooting Gallery|Shooting Gallery|
Simple Sprite Demo Release 2 by Nicolas Warren|Simple Sprite Demo Release 2 by Nicolas Warren|||
Simpsons: Bart vs. the Space Mutants|Simpsons, The - Bart vs. the Space Mutants|Simpsons, The - Bart vs. The Space Mutants|Simpsons, The - Bart vs. The Space Mutants|
Simpsons: Bart vs. the World|Simpsons, The - Bart vs. the World|Simpsons, The - Bart vs. The World|Simpsons, The - Bart vs. The World|
Sítio do Picapau Amarelo|Sitio do Picapau Amarelo|Sitio do Picapau Amarelo|Sitio do Picapau Amarelo|
Slap Shot|Slap Shot|Slap Shot|Slap Shot|
Slap Shot (USA) ()||Slap Shot (USA) ()||
Smash T.V.|||Smash T.V.|
SMS 3-D Demo by Chris Covell|SMS 3-D Demo by Chris Covell|||
SMS APA Demo V0.01 by Haroldo O. Pinheiro|SMS APA Demo V0.01 by Haroldo O. Pinheiro|||
SMS Boot Loader 0.9|SMS Boot Loader 0.9|||
SMS Cast: A Tribute To Loose Logic|SMS Cast - A Tribute To Loose Logic|||
SMS Chip-8 V0.1 by Maxim|SMS Chip-8 V0.1 by Maxim|||
SMS Chip-8 V0.21 by Maxim|SMS Chip-8 V0.21 by Maxim|||
SMS Chip-8 V1.11 by Maxim|SMS Chip-8 V1.11 by Maxim|||
SMSC Text Demo V2 by Super Majik Spiral Crew|SMSC Text Demo V2 by Super Majik Spiral Crew|||
SMS Palette by Omar Cornut|SMS Palette by Omar Cornut|||
SMS Power Demo Build 31 by Zoop|SMS Power Demo Build 31 by Zoop|||
SMS Power's 7th Anniversary Intro V1.00 by Nicolas Warren|SMS Power's 7th Anniversary Intro V1.00 by Nicolas Warren|||
SMS Power's 7th Anniversary Intro V1.03 by Nicolas Warren|SMS Power's 7th Anniversary Intro V1.03 by Nicolas Warren|||
SMS Prototype M404 BIOS|SMS Prototype M404 BIOS|||
SMS Sprite Test|SMS Sprite Test|||
SMS Store Display Unit BIOS|SMS Store Display Unit BIOS|||
SMS Tetris Release 2 by Nicolas Warren|SMS Tetris Release 2 by Nicolas Warren|||
SMS Tetris Release 3 by Nicolas Warren|SMS Tetris Release 3 by Nicolas Warren|||
SMS Tetris Release 4 by Nicolas Warren|SMS Tetris Release 4 by Nicolas Warren|||
SMS VGM player V0.45 by Maxim|SMS VGM player V0.45 by Maxim|||
Smurfs|Smurfs, The|Smurfs, The|Smurfs, The|
Smurfs Travel the World|Smurfs Travel the World, The||Smurfs Travel the World, The|
Snail Music Demo|Snail Music Demo|||
Solomon no Kagi: Oujo Rihita no Namida|||Solomon no Kagi - Oujo Rihita no Namida|
Solomon no Kagi: Oujo Rihita no Namida||Solomon no Kagi - Oujo Rihita no Namida||
Solomon no Kagi: Oujo Rihita no Namida|Solomon no Kagi - Oujo Rihita no Namida|||
Solomon's Key|Solomon's Key|||
Sonic 2 Rebirth|Sonic 2 Rebirth|||
Sonic Blast|Sonic Blast|Sonic Blast|Sonic Blast|
Sonic-Boy 2: Eggman's Trap|Sonic-Boy 2 - Eggman's Trap|||
Sonic-Boy 3: Eggman's Room|Sonic-Boy 3 - Eggman's Room|||
Sonic Boy 4: Monster World|Sonic Boy 4 - Monster World|||
Sonic-Boy in Monster Land|Sonic-Boy in Monster Land|||
Sonic Chaos|Sonic Chaos|Sonic Chaos|Sonic Chaos|
Sonic Spinball|Sonic Spinball|Sonic Spinball|Sonic Spinball|
Sonic The Hedgehog 2 (Europe) ()||Sonic The Hedgehog 2 (Europe) ()||
Sonic the Hedgehog 2 Rev 0|||Sonic the Hedgehog 2 Rev 0|
Sonic the Hedgehog 2 Rev 1|||Sonic the Hedgehog 2 Rev 1|
Sonic The Hedgehog 2|Sonic The Hedgehog 2|Sonic The Hedgehog 2|Sonic the Hedgehog|
Sonic The Hedgehog|Sonic The Hedgehog|Sonic The Hedgehog|Sonic the Hedgehog|
Sonic vs. os Mauniks|Sonic vs. os Mauniks|||
Sound Test by Nicolas Warren|Sound Test by Nicolas Warren|||
Space Gun|Spacegun|Space Gun|Space Gun|
Space Harrier 3D||Space Harrier 3D|Space Harrier 3D|
Space Harrier 3-D|Space Harrier 3D|Space Harrier 3-D|Space Harrier 3D|
Space Harrier|Space Harrier|Space Harrier|Space Harrier|
Space Oddity Demo by Tetsujin|Space Oddity Demo by Tetsujin|||
SpaceOddity|||SpaceOddity|
Space Oddity V.01 by Proppy & Tet|Space Oddity V.01 by Proppy & Tet|||
Space Oddity V.02 by Proppy & Tet|Space Oddity V.02 by Proppy & Tet|||
Space Oddity V.03 by Proppy & Tet|Space Oddity V.03 by Proppy & Tet|||
Space Oddity V.04 by Proppy & Tet|Space Oddity V.04 by Proppy & Tet|||
Space Oddity V.05 by Proppy & Tet|Space Oddity V.05 by Proppy & Tet|||
Space Oddity V.06 by Proppy & Tet|Space Oddity V.06 by Proppy & Tet|||
Space Oddity V.07 by Proppy & Tet|Space Oddity V.07 by Proppy & Tet|||
Space Oddity V.08 by Proppy & Tet|Space Oddity V.08 by Proppy & Tet|||
Space Oddity V.09 by Proppy & Tet|Space Oddity V.09 by Proppy & Tet|||
Space Oddity V.0 by Proppy & Tet|Space Oddity V.0 by Proppy & Tet|||
Space Oddity V.10 by Proppy & Tet|Space Oddity V.10 by Proppy & Tet|||
Space Oddity V.11 by Proppy & Tet|Space Oddity V.11 by Proppy & Tet|||
Space Oddity V.12 by Proppy & Tet|Space Oddity V.12 by Proppy & Tet|||
Space Oddity V.13 by Proppy & Tet|Space Oddity V.13 by Proppy & Tet|||
Space Oddity V.14 by Proppy & Tet|Space Oddity V.14 by Proppy & Tet|||
Space Oddity V.15 by Proppy & Tet|Space Oddity V.15 by Proppy & Tet|||
Space Oddity V.16 by Proppy & Tet|Space Oddity V.16 by Proppy & Tet|||
Space Oddity V.17 by Proppy & Tet|Space Oddity V.17 by Proppy & Tet|||
Space Oddity V.18 by Proppy & Tet|Space Oddity V.18 by Proppy & Tet|||
Space Oddity V.19 by Proppy & Tet|Space Oddity V.19 by Proppy & Tet|||
Space Oddity V.20 by Proppy & Tet|Space Oddity V.20 by Proppy & Tet|||
Space Oddity V.21 by Proppy & Tet|Space Oddity V.21 by Proppy & Tet|||
Space Oddity V.22 by Proppy & Tet|Space Oddity V.22 by Proppy & Tet|||
Space Oddity V.23 by Proppy & Tet|Space Oddity V.23 by Proppy & Tet|||
Special Criminal Investigation|Special Criminal Investigation|Special Criminal Investigation|Special Criminal Investigation|
Speedball 2: Brutal Deluxe|Speedball 2|Speedball 2|Speedball 2|
Speedball|Speedball|Speedball|Speedball|
Spellcaster|Spellcaster|SpellCaster|Spellcaster|
Spider-Man: Return of the Sinister Six|Spider-Man - Return of the Sinister Six|Spider-Man - Return of the Sinister Six|Spider-Man - Return of the Sinister Six|
Sport Pad Soccer|||Sport Pad Soccer|
Sports Pad Football|Sports Pad Football|Sports Pad Football|Sports Pad Football|
Sports Pad Soccer|Sports Pad Soccer|Sports Pad Soccer||
Sprite and Priority Test Program by Charles MacDonald|Sprite and Priority Test Program by Charles MacDonald|||
Sprite Multiplex Demo (03012005) by Charles MacDonald|Sprite Multiplex Demo (03012005) by Charles MacDonald|||
Spy vs. Spy|Spy vs. Spy|Spy vs. Spy|Spy vs Spy|
Star Wars|Star Wars|Star Wars|Star Wars|
Street Fighter II' - Champion Edition|Street Fighter 2|Street Fighter II|Street Fighter II'|
Streets of Rage 2|Streets of Rage 2|Streets of Rage II|Streets of Rage II|
Streets of Rage|Streets of Rage|Streets of Rage|Streets of Rage|
Strider 2|Strider II|Strider II|Strider II|
Strider|Strider|Strider|Strider|
Submarine Attack|Submarine Attack|Submarine Attack|Submarine Attack|
Sukeban Deka 2|Sukeban Deka 2|||
Sukeban Deka 2|||Sukeban Deka II|
Sukeban Deka II: Shoujo Tekkamen Densetsu||Sukeban Deka II - Shoujo Tekkamen Densetsu||
Summer Games|Summer Games|Summer Games|Summer Games|
Super Basketball|Super Basketball|Super Basketball||
Super Futebol|||Super Futebol|
Super Jeux Yeno Examples|Super Jeux Yeno Examples|||
Super Kick Off|Super Kick Off|Super Kick Off|Super Kick Off|
Super Magic Drive BIOS V3.1G|Super Magic Drive BIOS V3.1G|||
Super Magic Drive BIOS V3|Super Magic Drive BIOS V3|||
Super Magic Drive BIOS V4.1a|Super Magic Drive BIOS V4.1a|||
Superman|Superman||Superman|
Superman: The Man of Steel||Superman - The Man of Steel||
Super Monaco GP|Super Monaco GP|Super Monaco GP|Super Monaco GP|
Super Racing|Super Racing|Super Racing|Super Racing|
Super Smash T.V.||Super Smash T.V.||
Super Smash TV|Super Smash TV|||
Super Space Invaders|Super Space Invaders|Super Space Invaders|Super Space Invaders|
Super Tennis|Super Tennis|Super Tennis|Super Tennis|
Super Tetris|||Super Tetris|
Super Wonder Boy Monster Land|||Super Wonder Boy Monster Land|
Super Wonder Boy: Monster World||Super Wonder Boy - Monster World||
Super Wonder Boy: Monster World|Super Wonder Boy - Monster World|||
Super Wonder Boy|Super Wonder Boy|Super Wonder Boy|Super Wonder Boy|
Tanoshii Sansuu|Tanoshii Sansuu|||
Taz in Escape from Mars|Taz in Escape From Mars|Taz in Escape from Mars|Taz in Escape From Mars|
Taz-Mania|Taz-Mania|Taz-Mania|Taz-Mania|
Tecmo World Cup '92|Tecmo World Cup '92|Tecmo World Cup '92||
Tecmo World Cup '93|Tecmo World Cup '93|Tecmo World Cup '93||
Teddy Boy Blues|Teddy Boy Blues|Teddy Boy Blues|Teddy Boy Blues|
Teddy Boy e Geraldinho|Teddy Boy e Geraldinho|||
Teddy Boy|Teddy Boy|Teddy Boy|Teddy Boy|
Temco World Cup '93|||Temco World Cup '93|
Tennis Ace|Tennis Ace|Tennis Ace|Tennis Ace|
Tensai Bakabon|Tensai Bakabon|Tensai Bakabon|Tensai Bakabon|
Terminator 2 - Judgment Day||T2 - The Arcade Game|T2 - Arcade Game, The|
Terminator 2 - Judgment Day|Terminator 2 - Judgment Day|Terminator 2 - Judgment Day|Terminator 2 - Judgment Day|
Terminator 2: The Arcade Game|Terminator 2 - The Arcade Game|||
Terminator|||Terminator, The|
Terminator|Terminator, The|Terminator, The||
Tetracycline|||Tetracycline|
The Addams Family|Addams Family, The|Addams Family, The|Addams Family, The|
Three Dragon Story|||Three Dragon Story, The|
Three Dragon Story|Three Dragon Story, The|||
Thunder Blade|Thunder Blade|Thunder Blade|Thunder Blade|
Time Soldiers|Time Soldiers|Time Soldiers|Time Soldiers|
Tom and Jerry: Movie|||Tom and Jerry - Movie, The|
Tom and Jerry: The Movie||Tom and Jerry - The Movie||
Tom and Jerry: The Movie|Tom and Jerry - The Movie|||
Tom and Jerry|Tom and Jerry|||
Tom and Jerry||Tom & Jerry|Tom & Jerry|
Tototek Menu Boot: SG-1000 Mode by Chris Covell|Tototek Menu Boot - SG-1000 Mode by Chris Covell|||
Tototek Menu Boot: SMS Mode by Chris Covell|Tototek Menu Boot - SMS Mode by Chris Covell|||
Toto World 3|Toto World 3|Toto World 3|Toto World 3|
TransBot|Trans-Bot|TransBot|Transbot|
Trap Shooting + Marksman Shooting + Safari Hunt|||Trap Shooting + Marksman Shooting + Safari Hunt|
Trap Shooting: Marksman Shooting: Safari Hunt|Trap Shooting - Marksman Shooting - Safari Hunt|||
Treinamento Do Guerreiro Lobo|Treinamento Do Guerreiro Lobo|||
Treinamento Do Mymo|Treinamento Do Mymo|||
Trivial Pursuit: Genus Edition||Trivial Pursuit - Genus Edition||
Trivial Pursuit|Trivial Pursuit||Trivial Pursuit|
Turma da Monica 3 v01|Turma da Monica 3 v01|||
Turma da Mônica em: O Resgate|Turma da Monica em - O Resgate|Turma da Monica em O Resgate|Turma da Monica em O Resgate|
TV Colosso||TV Colosso||
Ultima 4|||Ultima IV|
Ultima III V2006-05-13prealpha|Ultima III V2006-05-13prealpha|||
Ultima IV: Quest of the Avatar|Ultima IV - Quest of the Avatar|Ultima IV - Quest of the Avatar||
Ultimate Soccer|Ultimate Soccer|Ultimate Soccer|Ultimate Soccer|
Unite Centrale de Huit Bits by Comic Bakery|Unite Centrale de Huit Bits by Comic Bakery|||
US-European SMS BIOS + Alex Kidd in Miracle World|US-European SMS BIOS + Alex Kidd in Miracle World|||
US-European SMS BIOS V1.3|US-European SMS BIOS V1.3|||
US-European SMS BIOS V2.4|US-European SMS BIOS V2.4|||
US-European SMS BIOS V3.4|US-European SMS BIOS V3.4|||
Vampire|Vampire|Vampire|Vampire|
V Counter Test by Charles MacDonald|V Counter Test by Charles MacDonald|||
Vigilante|Vigilante|Vigilante|Vigilante|
Vik 1|Vik 01|||
Virtua Fighter Animation|Virtua Fighter Animation|Virtua Fighter Animation|Virtua Fighter Animation|
Walter Payton Football|Walter Payton Football|Walter Payton Football|Walter Payton Football|
Wanted|Wanted|Wanted|Wanted|
Where in the World is Carmen Sandiego|Where in the World is Carmen Sandiego|Where in the World is Carmen Sandiego|Where in the World is Carmen Sandiego|
Wimbledon 2|Wimbledon II|Wimbledon II|Wimbledon II|
Wimbledon|Wimbledon|Wimbledon||
Winter Olympics: Lillehammer '94|Winter Olympics '94|Winter Olympics - Lillehammer '94||
Wolfchild|Wolf Child|Wolfchild|Wolfchild|
Wonder Boy III D.C.|Wonder Boy III D.C.|||
Wonder Boy III: The Dragon's Trap|Wonder Boy III - The Dragon's Trap|Wonder Boy III - The Dragon's Trap|Wonder Boy III|
Wonder Boy in Monster Land|Wonder Boy in Monster Land|Wonder Boy in Monster Land|Wonder Boy in Monster Land|
Wonder Boy in Monster World|Wonder Boy in Monster World|Wonder Boy in Monster World|Wonder Boy in Monster World|
Woody Pop: Shinjinrui no Block Kuzushi||Woody Pop - Shinjinrui no Block Kuzushi||
Woody Pop|Woody Pop||Woody Pop|
World Championship Soccer|World Championship Soccer|||
World Class Leaderboard|World Class Leaderboard|World Class Leader Board|World Class Leader Board|
World Cup Italia '90|World Cup Italia '90|World Cup Italia '90|World Cup Italia '90|
World Cup USA '94|World Cup '94|World Cup USA 94|World Cup USA 94|
World Games|World Games|World Games|World Games|
World Grand Prix|World Grand Prix|World Grand Prix|World Grand Prix|
World Soccer|World Soccer|World Soccer|World Soccer|
WWF Wrestlemania Steel Cage Challenge|WWF Wrestlemania Steel Cage Challenge|||
WWF Wrestlemania: Steel Cage Challenge||WWF Wrestlemania - Steel Cage Challenge||
WWF WrestleMania Steel Cage Challenge|||WWF WrestleMania Steel Cage Challenge|
Xenon 2: Megablast|Xenon 2|Xenon 2 - Megablast|Xenon 2|
Xevious|Xevious|||
X-Men: Mojo World|X-Men - Mojo World|X-Men - Mojo World|X-Men - Mojo World|
XVII Olympic Winter Olympics Games, The: Lillehammer 1994|||XVII Olympic Winter Olympics Games, The - Lillehammer 1994|
Yeno Draw|Yeno Draw|||
Ys: Ancient Ys Vanished Omen|||Ys - Ancient Ys Vanished Omen|
Ys: The Vanished Omens|Ys - The Vanished Omens|||
Ys|Ys|||
Zaxxon 3-D|Zaxxon 3D|Zaxxon 3-D|Zaxxon 3D|
ZEXALL V0.12SDSC by Maxim & Eric Quinn|ZEXALL V0.12SDSC by Maxim & Eric Quinn|||
ZEXALL V0.12VDP by Maxim & Eric Quinn|ZEXALL V0.12VDP by Maxim & Eric Quinn|||
Zillion 2: Tri Formation|Zillion II - The Tri Formation|Zillion II - The Tri Formation|Tri Formation|
Zillion (Europe) ()||Zillion (Europe) ()||
Zillion (USA) ()||Zillion (USA) ()||
Zillion|Zillion|Zillion|Zillion|
Zool: Ninja of the 'Nth' Dimension||Zool - Ninja of the 'Nth' Dimension||
Zool|Zool||Zool|
Zoom Effect #1_1 by Charles MacDonald|Zoom Effect #1_1 by Charles MacDonald|||
Zoom Effect #1_2 by Charles MacDonald|Zoom Effect #1_2 by Charles MacDonald|||
Zoom Effect #1_3 by Charles MacDonald|Zoom Effect #1_3 by Charles MacDonald|||
Zoop's Birthday Demo|Zoop's Birthday Demo|||
