007: Licence to Kill|||License to Kill|
10 of the Best Education Games|10 of the Best Education Games|||
10 of the Best Games|10 of the Best Games|||
180 Darts|180 Darts|||
1984|1984|||
2002 Rendezvous and Docking Simulator|2002 Rendezvous and Docking Simulator|||
3D Convoy|3D Convoy|||
3D Dotty|3D Dotty|||
3-Deep Space|3-Deep Space|||
3D Grand Prix|3D Grand Prix|||
3D Maze|3D Maze|||
3D Munchy|3D Munchy|||
3D Pool|3D Pool|||
3D Snooker|3D Snooker|||
3-D Space Raider|3-D Space Raider|||
3D Space Ranger|3D Space Ranger|||
3D Tank Zone|3D Tank Zone|||
3D Tanx|3D Tanx||3D Tanx|
3D Wars|3D Wars|||
737 Flight Simulator|737 Flight Simulator||737 Flight Simulator|
747|747||747|
747 Flight Simulator|747 Flight Simulator||747 Flight Simulator|
9 Classic Card and Board Games: No. 1|9 Classic Card and Board Games - No. 1|||
9 Classic Card and Board Games: No. 2|9 Classic Card and Board Games - No. 2|||
Aabatron|Aabatron|||
ABC|ABC|||
Abyss|Abyss||Abyss|
Aces High|Aces High|||
Acheton|Acheton||Acheton|
Acid Drops|Acid Drops|||
Acorn Adventure|Acorn Adventure|||
Adventure 01: Adventureland|||Adventure 01 - Adventureland - BBC|
Adventure #10: Savage Island Part I|Adventure #10 - Savage Island Part I|||
Adventure #11: Savage Island Part II|Adventure #11 - Savage Island Part II|||
Adventure #15: Buckaroo Banzai|Adventure #15 - Buckaroo Banzai|||
Adventure #1: Adventureland|Adventure #1 - Adventureland|||
Adventure #2: Pirate Adventure|Adventure #2 - Pirate Adventure|||
Adventure #3: Secret Mission|Adventure #3 - Secret Mission|||
Adventure #4: Voodoo Castle|Adventure #4 - Voodoo Castle|||
Adventure #5: The Count|Adventure #5 - The Count|||
Adventure #6: Strange Odyssey|Adventure #6 - Strange Odyssey|||
Adventure #7: Mystery Fun House|Adventure #7 - Mystery Fun House|||
Adventure #8: Pyramid of Doom|Adventure #8 - Pyramid of Doom|||
Adventure #9: Ghost Town|Adventure #9 - Ghost Town|||
Adventure|Adventure|||
Adventure Anthology|Adventure Anthology|||
Adventure Creator|Adventure Creator|||
Adventure Quest|Adventure Quest||Adventure Quest|
Adventurescape|Adventurescape|||
Adventurescape: Amnesia & Xanadu|Adventurescape - Amnesia & Xanadu|||
Adventurescape Generator|Adventurescape Generator|||
Adventuresoft|Adventuresoft|||
Adventure Writer|Adventure Writer|||
Airbrush|Airbrush|||
Aircraft Landing Simulator|Aircraft Landing Simulator|||
Airlift|Airlift|||
Airline|Airline|||
Air-Traffic Control Simulator|Air-Traffic Control Simulator|||
Airwolf|Airwolf||Airwolf|
Alien 8|Alien 8||Alien 8|
Alien Blaster|Alien Blaster|||
Alien Break-In|Alien Break-In|||
Alien Destroyers|Alien Destroyers|||
Alien Destroyers II|Alien Destroyers II|||
Alien Dropout|Alien Dropout||Alien Dropout|
Alien From Outta Space|Alien From Outta Space|||
Alien Swirl|Alien Swirl||Alien Swirl|
AllyPally|AllyPally|||
Alphabet Soup|Alphabet Soup|||
Alphatron|Alphatron|||
American Suds|American Suds|||
Amnesia|Amnesia|||
Anarchy Zone|Anarchy Zone||Anarchy Zone|
Android|Android|||
Android Attack|Android Attack|||
Animal-Vegetable-Mineral|Animal-Vegetable-Mineral|||
Annabel Gray|Annabel Gray|||
Answer Back General Knowledge Junior Quiz|Answer Back General Knowledge Junior Quiz|||
Answer Back General Knowledge Senior Quiz|Answer Back General Knowledge Senior Quiz|||
Answer Back Sports Quiz|Answer Back Sports Quiz|||
Antix|Antix|||
Ant Killer|Ant Killer|||
Apocalypse|Apocalypse|||
Apollo|Apollo|||
Apple Pie|Apple Pie|||
April Showers|April Showers|||
Aqua Attack|Aqua Attack|||
A Question of Sport|||Question of Sport, A|
Arcade Action|Arcade Action|||
Arcade Soccer!|Arcade Soccer!|||
Arcadia|Arcadia|||
Arcadians|Arcadians|||
Arc Pinball|Arc Pinball|||
Area Radar Controller|Area Radar Controller|||
Arena 3000|Arena 3000||Arena 3000|
Arkanoid|Arkanoid||Arkanoid|
Ask: The Real You|Ask - The Real You|||
Asteroid Belt|Asteroid Belt|||
Asteroid Miner|Asteroid Miner|||
Asteroids Deluxe|Asteroids Deluxe|||
Asteroid Storm|Asteroid Storm|||
Astroblaster|Astroblaster|||
Astro Navigator|Astro Navigator|||
Astro Plumber|Astro Plumber|||
Astro Tracker|Astro Tracker|||
Asylum|Asylum|||
Atic Atac|Atic Atac|||
Atomic Protector|Atomic Protector|||
Atom Smasher|Atom Smasher|||
Attack on Alpha Centauri|Attack on Alpha Centauri|||
Auf Wiedersehen Pet|Auf Wiedersehen Pet|||
Aviator|Aviator|||
Avon|Avon|||
Awari|Awari|||
Axe of Kolt|Axe of Kolt|||
AYO: The Game of Africa|AYO - The Game of Africa|||
Backgammon|Backgammon|||
Ballistix!|Ballistix!|||
Balloon Buster|Balloon Buster|||
Balloon Fun|Balloon Fun|||
Balloons|Balloons|||
Balls!|Balls!|||
Banana Man|Banana Man|||
Bandit|Bandit|||
Bandits|Bandits|||
Banjax|Banjax|||
Barbarian|Barbarian|||
Barbarian II|Barbarian II|||
Bar Billiards|Bar Billiards|||
Baron|Baron|||
Barrage|Barrage|||
Battle 1917|Battle 1917|||
Battlefields|Battlefields|||
Battle of Atlantis|Battle of Atlantis|||
Battle of Britain|Battle of Britain|||
Battle Planet|Battle Planet|||
Battle Tank|Battle Tank|||
Battle Zone 2000|Battle Zone 2000|||
BBC Backgammon|BBC Backgammon|||
BBC Bonanza|BBC Bonanza|||
BBC Mastermind|BBC Mastermind|||
B.C. Bill|B.C. Bill|||
Beach-Head|Beach-Head|||
Bed Bugs|Bed Bugs|||
Beeb-Beep|Beeb-Beep|||
Beeb-Darts|Beeb-Darts|||
Beebgammon|Beebgammon|||
Beebmunch|Beebmunch|||
Beeb-Tote|Beeb-Tote|||
Beebtrek|Beebtrek|||
Beeline|Beeline|||
Bert Boot|Bert Boot|||
Beseiged|Beseiged|||
Beverly Hills Cop|Beverly Hills Cop|||
Beyond Infinity: Cute to Kill|Beyond Infinity - Cute to Kill|||
Birdie Barrage|Birdie Barrage|||
Birds of Prey|Birds of Prey|||
Bird Strike|Bird Strike|||
Birmingham New Street Station Control|Birmingham New Street Station Control|||
Bismarck|Bismarck|||
Black Box|Black Box|||
Blackjack|Blackjack|||
Black Queen or the Game of Bridge|Black Queen or the Game of Bridge|||
Black Widow II|Black Widow II|||
Blagger|Blagger|||
Blast!|Blast!|||
Blitzkrieg|Blitzkrieg|||
Blockade|Blockade|||
Block Blitz|Block Blitz|||
Blockbuster|Blockbuster|||
Blockbusters|Blockbusters|||
Blockbusters Goldrun|Blockbusters Goldrun|||
Blocker|Blocker|||
Blokkendoos: Extended Version|Blokkendoos - Extended Version|||
Blokkendoos Plus|Blokkendoos Plus|||
Blood of the Mutineers|Blood of the Mutineers|||
Blue Dragon|Blue Dragon|||
BMX on the Moon|BMX on the Moon|||
Bobby Charlton Soccer|Bobby Charlton Soccer|||
Boffin 2|Boffin 2|||
Boffin|Boffin|||
Bomb Alley|Bomb Alley|||
Bomber Baron|Bomber Baron|||
Bomber|Bomber|||
Bomber Scramble|Bomber Scramble|||
Bone Cruncher|Bone Cruncher|||
Boot Hill|Boot Hill|||
Bored of the Rings|Bored of the Rings|||
Boris in the Underworld|Boris in the Underworld|||
Boulder Crash|Boulder Crash|||
Boulder Dash|Boulder Dash|||
Bouncer|Bouncer|||
Bouncing Bill|Bouncing Bill|||
Bounds Green|Bounds Green|||
Bounty Bob Strikes Back|Bounty Bob Strikes Back|||
Boxer|Boxer|||
Bozo and Beebo|Bozo and Beebo|||
Bozo the Brave|Bozo the Brave|||
Brain Aerobics|Brain Aerobics|||
Brainstorm|Brainstorm|||
Brain Teasers|Brain Teasers|||
Braz|Braz|||
Breakout|Breakout|||
Break Through|Break Through|||
Brian Clough's Football Fortunes|Brian Clough's Football Fortunes|||
Brian Jack's Superstar Challenge|Brian Jack's Superstar Challenge|||
Brick 'Em In|Brick 'Em In|||
Bridge|Bridge|||
BridgeMaster|BridgeMaster|||
Bridge Mentor II|Bridge Mentor II|||
Bridge to the East|Bridge to the East|||
Bruce Forsyth's Play Your Cards Right|Bruce Forsyth's Play Your Cards Right|||
Bruce Lee|Bruce Lee|||
Bubble Bobble!|Bubble Bobble!|||
Buffalo Bill's Wild West Show|Buffalo Bill's Wild West Show|||
Bug Blaster|Bug Blaster|||
Bug Bomb|Bug Bomb|||
Bug Eyes 2: Starman to the Rescue|Bug Eyes 2 - Starman to the Rescue|||
Bug Eyes|Bug Eyes|||
Build n Break|Build n Break|||
Bullseye|Bullseye|||
Bumble Bee|Bumble Bee|||
Bun Fun|Bun Fun|||
Business Games|Business Games|||
Buxton Railfreight Control|Buxton Railfreight Control|||
By Fair Means... or Foul|By Fair Means... or Foul|||
Caesar the Cat|Caesar the Cat|||
Camelot|Camelot|||
Candy Floss|Candy Floss|||
Canyon Battle|Canyon Battle|||
Carnival|Carnival|||
Carousel|Carousel|||
Car Wars|Car Wars|||
Cascade 50|Cascade 50|||
Castle Assault|Castle Assault|||
Castle Blackstar|Castle Blackstar|||
Castle Dracula|Castle Dracula|||
Castle Frankenstein|Castle Frankenstein|||
Castlemaze Adventure|Castlemaze Adventure|||
Castle of Gems|Castle of Gems|||
Castle of Riddles|Castle of Riddles|||
Castle of the Skull Lord|Castle of the Skull Lord|||
Castle Quest|Castle Quest|||
Castle Raider|Castle Raider|||
Cat and Mouse|Cat and Mouse|||
Caterpillar|Caterpillar|||
Caveman Adventure|Caveman Adventure|||
Caveman Capers|Caveman Capers|||
Cavey|Cavey|||
Cells and Serpents|Cells and Serpents|||
Centipede|Centipede|||
Challenger|Challenger|||
Champions!|Champions!|||
Chark|Chark|||
Checkouts|Checkouts|||
Cheshire Cat|Cheshire Cat|||
Chess|Chess|||
Chicane|Chicane|||
Chichen Itza|Chichen Itza|||
Chickaroo|Chickaroo|||
Chieftan|Chieftan|||
Children from Space|Children from Space|||
Chip Buster|Chip Buster|||
Cholo|Cholo|||
Chopper II|Chopper II|||
Christmas Crackers|Christmas Crackers|||
Chrysalis|Chrysalis|||
Chuckie Egg 2|Chuckie Egg 2|||
Chuckie Egg|Chuckie Egg|||
Circus|Circus|||
Circus Games|Circus Games|||
Citadel 2|Citadel 2|||
Citadel|Citadel|||
City Defence|City Defence|||
City Defend|City Defend|||
Class 50 Fleet Manager|Class 50 Fleet Manager|||
Classic Adventure|Classic Adventure|||
Classic Arcade Games|Classic Arcade Games|||
Clogger|Clogger|||
Clown|Clown|||
Cluedo|Cluedo|||
Codename Droid: Stryker's Run Part 2|Codename Droid - Stryker's Run Part 2|||
Colditz Adventure|Colditz Adventure|||
Colditz!|Colditz!|||
Colony|Colony|||
Colossal Adventure|Colossal Adventure|||
Colossus 4.0: Bridge|Colossus 4.0 - Bridge|||
Colossus 4.0: Chess|Colossus 4.0 - Chess|||
Combat Lynx|Combat Lynx|||
Combat Phantom|Combat Phantom|||
Commando|Commando|||
Commonwealth Games|Commonwealth Games|||
Condition Red|Condition Red|||
Confrontation|Confrontation|||
Confuzion|Confuzion|||
Conquering Everest|Conquering Everest|||
Contract Bridge|Contract Bridge|||
Contraption|Contraption|||
Cookie|Cookie|||
Cops|Cops|||
Cops n Robbers|Cops n Robbers|||
Copter Capers|Copter Capers|||
Corn Cropper|Corn Cropper|||
Cornish Riviera|Cornish Riviera|||
Corporate Climber|Corporate Climber|||
Corpuscle|Corpuscle|||
Cosmic Asteroids|Cosmic Asteroids|||
Cosmic Camouflage|Cosmic Camouflage|||
Cosmic Combat|Cosmic Combat|||
Cosmic Cruiser|Cosmic Cruiser|||
Cosmic Fighter|Cosmic Fighter|||
Cosmic Kidnap|Cosmic Kidnap|||
Cosmos|Cosmos|||
Countdown|Countdown|||
Countdown to Doom|Countdown to Doom|||
Cowboy Shootout|Cowboy Shootout|||
Crack-Up|Crack-Up|||
Cranky|Cranky|||
Crawler|Crawler|||
Crazee Rider|Crazee Rider|||
Crazy Balloon|Crazy Balloon|||
Crazy Caves|Crazy Caves|||
Crazy Erbert|Crazy Erbert|||
Crazy Painter|Crazy Painter|||
Crazy Tracer|Crazy Tracer|||
Cred Breaks Out!|Cred Breaks Out!|||
Creepy Cave|Creepy Cave|||
Crewe Station Control|Crewe Station Control|||
Cribbage|Cribbage|||
Cricket|Cricket|||
Crime and Detection|Crime and Detection|||
Croaker|Croaker|||
CroakIt|CroakIt|||
Crown of Mardan|Crown of Mardan|||
Cruncher|Cruncher|||
Crypt Capers|Crypt Capers|||
Crystal Castle|Crystal Castle|||
Crystal Castles|Crystal Castles|||
Cube Master|Cube Master|||
Cubert|Cubert|||
Culbertson's Revenge: Brain Aerobics|Culbertson's Revenge - Brain Aerobics|||
Custard Pie Fight|Custard Pie Fight|||
Cutter|Cutter|||
Cybertron|Cybertron|||
Cyborg Warriors|Cyborg Warriors|||
Cylon Attack|Cylon Attack|||
Cylon Invasion|Cylon Invasion|||
Daley Thompson's Super Test|Daley Thompson's Super Test|||
Dallas|Dallas|||
Dambusters|Dambusters|||
Danger UXB|Danger UXB|||
DanoSoft Collection|DanoSoft Collection|||
Dare Devil Denis|Dare Devil Denis|||
Darts|Darts|||
Dead or Alive|Dead or Alive|||
Death's Head Hole|Death's Head Hole|||
Death Star|Death Star|||
Defence Com|Defence Com|||
Defender|Defender|||
Deltic Fleet Manager|Deltic Fleet Manager|||
Demolator|Demolator|||
Demolish|Demolish|||
Demon Decorator|Demon Decorator|||
Demon Knight|Demon Knight|||
Denis Through the Drinking Glass|Denis Through the Drinking Glass|||
Depotmaster Finsbury Park|Depotmaster Finsbury Park|||
Depotmaster Old Oak Common|Depotmaster Old Oak Common|||
Despatch Rider|Despatch Rider|||
Desperate Dan's Dungeon|Desperate Dan's Dungeon|||
Devil's Causeway|Devil's Causeway|||
Diamond Mine|Diamond Mine|||
Diamond Mine II|Diamond Mine II|||
Diamonds|Diamonds|||
Dickie Brickie|Dickie Brickie|||
Dictator|Dictator|||
Digger!|Digger!|||
Dingbat|Dingbat|||
Dino and the Saurus Races|Dino and the Saurus Races|||
Dinosaur Discovery|Dinosaur Discovery|||
Dive-Bomber|Dive-Bomber|||
Division One 85|Division One 85|||
Doctor Who and the Mines of Terror!|Doctor Who and the Mines of Terror!|||
Doctor Who and the Warlord|Doctor Who and the Warlord|||
Doctor Who: The First Adventure|Doctor Who - The First Adventure|||
Dodge'Em|Dodge'Em|||
Dodge Ems|Dodge Ems|||
Dodgy Geezers|Dodgy Geezers|||
DogFight|DogFight|||
Dominion|Dominion|||
Dominoes|Dominoes|||
Doncaster Station Control|Doncaster Station Control|||
Donkey Kong Jr.|Donkey Kong Jr.|||
Doodle|Doodle|||
Double Phantom Combat|Double Phantom Combat|||
Dracula Island|Dracula Island|||
Dragon Quest|Dragon Quest|||
Dragon Rider|Dragon Rider|||
Dragon's Tooth|Dragon's Tooth|||
Drain Mania|Drain Mania|||
Draughts Challenger|Draughts Challenger|||
Draughts|Draughts|||
Dream Time|Dream Time|||
Drogna|Drogna|||
Drunken Dan|Drunken Dan|||
Duck!|Duck!|||
Duck Shoot|Duck Shoot|||
Dune Hunter|Dune Hunter|||
Dune Rider|Dune Rider|||
Dungeon Adventure|Dungeon Adventure|||
Dunjunz|Dunjunz|||
Eagle|Eagle|||
Eagle Empire|Eagle Empire|||
Eagle's Wings|Eagle's Wings|||
Early Number: Betty the Butterfly|Early Number - Betty the Butterfly|||
Early Number: Clarry the Caterpillar|Early Number - Clarry the Caterpillar|||
Early Number: Dippy the Dinosaur|Early Number - Dippy the Dinosaur|||
Early Number: Floppy the Fish|Early Number - Floppy the Fish|||
Early Number: Sidney the Snake|Early Number - Sidney the Snake|||
Early Number: Spiro the Snail|Early Number - Spiro the Snail|||
Early Number: Tommy the Tortoise|Early Number - Tommy the Tortoise|||
Eastwood Manor|Eastwood Manor|||
Ebony Tower|Ebony Tower|||
Eddie Kidd Jump Challenge|Eddie Kidd Jump Challenge|||
Egyptian Adventure|Egyptian Adventure|||
Eldorado Gold|Eldorado Gold|||
Electro Freddy|Electro Freddy|||
Electron Invaders|Electron Invaders|||
Elite|Elite|||
Elixir|Elixir|||
Emerald Isle|Emerald Isle|||
Emily|Emily|||
Emlyn Hughes Arcade Quiz|Emlyn Hughes Arcade Quiz|||
Emperor|Emperor|||
Empire|Empire|||
English Civil War|English Civil War|||
Enigma!|Enigma!|||
Enthar Seven: The Mega Adventure|Enthar Seven - The Mega Adventure|||
Er-Bert|Er-Bert|||
Escape from Orion|Escape from Orion|||
Espionage|Espionage|||
Estra|Estra|||
E-Type|E-Type|||
European Knowledge|European Knowledge|||
Evening Star|Evening Star|||
Evil Weevils|Evil Weevils|||
Ewgeebez|Ewgeebez|||
Exile|Exile|||
Explorer|Explorer|||
Exterminator|Exterminator|||
Eyes|Eyes|||
Eye vs Eye|Eye vs Eye|||
F14 Tomcat|F14 Tomcat|||
Fab Four|Fab Four|||
Facemaker|Facemaker|||
Fairground|Fairground|||
Family Games|Family Games|||
Fantasia Diamond|Fantasia Diamond|||
Fat Man Sam|Fat Man Sam|||
Felix and the Fruit Monsters|Felix and the Fruit Monsters|||
Felix in the Factory|Felix in the Factory|||
Felix Meets the Evil Weevils|Felix Meets the Evil Weevils|||
F for Freddie|F for Freddie|||
Fighter Pilot|Fighter Pilot|||
Finsbury Park|Finsbury Park|||
Firebug|Firebug|||
Firechief|Firechief|||
Fire Hawks|Fire Hawks|||
Fire Island|Fire Island|||
Fireman|Fireman|||
Fire Track|Fire Track|||
Firien Wood|Firien Wood|||
First Moves Chess|First Moves Chess|||
Five-A-Side Football|Five-A-Side Football|||
Flags|Flags|||
Flash|Flash|||
Fletcher's Castle|Fletcher's Castle|||
Flight Simulation|Flight Simulation|||
Flight Simulator|Flight Simulator|||
Flint's Gold|Flint's Gold|||
Flint Strikes Back|Flint Strikes Back|||
Flip!|Flip!|||
Flipper|Flipper|||
Flowers of Crystal|Flowers of Crystal|||
Flying Scotsman|Flying Scotsman|||
Football Director|Football Director|||
Footballer of the Year|Footballer of the Year|||
Football|Football|||
Football Manager|Football Manager|||
Forbidden Fruit|Forbidden Fruit|||
Fortress|Fortress|||
Frak!|Frak!|||
Frankenstein 2000|Frankenstein 2000|||
Franklin's Tomb|Franklin's Tomb|||
Free Fall|Free Fall|||
French on the Run|French on the Run|||
Frenzy|Frenzy|||
Frogger|Frogger|||
Froggy|Froggy|||
Froglet|Froglet|||
From Pictures to Words|From Pictures to Words|||
Fruit Catcher|Fruit Catcher|||
Fruit Machine|Fruit Machine|||
Fruit Machine Simulator|Fruit Machine Simulator|||
Fruit Worm|Fruit Worm|||
Fruity Freddy|Fruity Freddy|||
F.S.S. Liberator|F.S.S. Liberator|||
Fun Fair|Fun Fair|||
Fun School 2: 6 to 8|Fun School 2 - 6 to 8|||
Fun School 2: Over 8|Fun School 2 - Over 8|||
Fun School 2: Under 6|Fun School 2 - Under 6|||
Fun School: Under 12s|Fun School - Under 12s|||
Fun School: Under 5s|Fun School - Under 5s|||
Fun School: Under 8s|Fun School - Under 8s|||
Fun with Numbers|Fun with Numbers|||
Future Shock|Future Shock|||
Galactic Commander|Galactic Commander|||
Galactic Empire|Galactic Empire|||
Galactic Firebird|Galactic Firebird|||
Galactic Patrol|Galactic Patrol|||
Galactic Wipeout|Galactic Wipeout|||
Galadriel in Distress|Galadriel in Distress|||
Galaforce 2|Galaforce 2|||
Galaforce|Galaforce|||
Galaxians|Galaxians|||
Galaxy Birds|Galaxy Birds|||
Galaxy Raiders|Galaxy Raiders|||
Galaxy Wars|Galaxy Wars|||
Galilee|Galilee|||
Gambit|Gambit|||
Games Galore|Games Galore|||
Games of Logic|Games of Logic|||
Garden|Garden|||
Gate Crasher|Gate Crasher|||
Gateway to Karos|Gateway to Karos|||
Gateway to the Skies|Gateway to the Skies|||
Gatwick Express|Gatwick Express|||
Gauntlet|Gauntlet|||
Geoff Capes Strong Man|Geoff Capes Strong Man|||
Geordie Racer|Geordie Racer|||
Ghost Hunter|Ghost Hunter|||
Ghosts|Ghosts|||
Ghouls|Ghouls|||
Giantkiller|Giantkiller|||
Gideon's Gamble|Gideon's Gamble|||
Gimpo|Gimpo|||
Gisburne's Castle|Gisburne's Castle|||
Glider Pilot|Glider Pilot|||
Gnome Adventure|Gnome Adventure|||
Gnome Ranger|Gnome Ranger|||
Goal!|Goal!|||
Gobbler|Gobbler|||
Go|Go|||
Going Places|Going Places|||
Gold Digger|Gold Digger|||
Gold Run|Gold Run|||
Golf|Golf|||
Gomoku|Gomoku|||
Gorf|Gorf|||
Grabit|Grabit|||
Graham Gooch's Test Cricket|Graham Gooch's Test Cricket|||
Grand Prix Construction Set|Grand Prix Construction Set|||
Granny's Garden|Granny's Garden|||
Graphic Adventure Creator|Graphic Adventure Creator|||
Great Britain Limited|Great Britain Limited|||
Greedy Dwarf|Greedy Dwarf|||
Green Beret|Green Beret|||
Gremlins: The Adventure|Gremlins - The Adventure|||
Gridiron 2|Gridiron 2|||
Grid Iron|Grid Iron|||
Growing Pains|Growing Pains|||
Guardian|Guardian|||
Guardian of Doomsday|Guardian of Doomsday|||
Gulp!|Gulp!|||
Gunfighter|Gunfighter|||
Gunsmoke|Gunsmoke|||
Gyroscope|Gyroscope|||
Hacker 2000|Hacker 2000|||
Hangdroid|Hangdroid|||
Hangman|Hangman|||
Happy Numbers|Happy Numbers|||
Hard Hat Harry 2|Hard Hat Harry 2|||
Hard Hat Harry|Hard Hat Harry|||
Hareraiser|Hareraiser|||
Harlequin|Harlequin|||
Harvey Headbanger|Harvey Headbanger|||
Hatrace Game|Hatrace Game|||
Head Coach Deluxe|Head Coach Deluxe|||
Heathrow ATC|Heathrow ATC|||
Hedgehog|Hedgehog|||
Heist|Heist|||
Helldriver|Helldriver|||
Hellforce|Hellforce|||
Hell-Hole|Hell-Hole|||
Helter Skelter|Helter Skelter|||
Hercules|Hercules|||
Hexagram of Trutania Valley|Hexagram of Trutania Valley|||
Hex|Hex|||
Hide and Seek|Hide and Seek|||
High Bouncers|High Bouncers|||
High Noon|High Noon|||
High Rise Horror|High Rise Horror|||
Hi-Q Quiz|Hi-Q Quiz|||
History of Micro User Games Volume 1|History of Micro User Games Volume 1|||
History Quiz|History Quiz|||
Hitch Hiker|Hitch Hiker|||
Hobgoblin|Hobgoblin|||
Hobgoblin II|Hobgoblin II|||
Hockey|Hockey|||
Holed Out: Cone Links & Pine Isles|Holed Out - Cone Links & Pine Isles|||
Holed Out: Dune Royal & Owlet Wood|Holed Out - Dune Royal & Owlet Wood|||
Holed Out: Glen Aigre & Eagle Park|Holed Out - Glen Aigre & Eagle Park|||
Holy Horrors|Holy Horrors|||
Honest Joe|Honest Joe|||
Honeybug|Honeybug|||
Honey Logo|Honey Logo|||
Hopper|Hopper|||
Horror Castle|Horror Castle|||
Horse Race|Horse Race|||
Hostages|Hostages|||
House of Horrors|House of Horrors|||
Howszat|Howszat|||
Hubert|Hubert|||
Humphrey|Humphrey|||
Hunchback|Hunchback|||
Hunkidory|Hunkidory|||
Hunkie Egg|Hunkie Egg|||
Hyperball|Hyperball|||
Hyperdrive|Hyperdrive|||
Hyper Sports|Hyper Sports|||
Hyper Viper|Hyper Viper|||
Ian Botham's Test Match|Ian Botham's Test Match|||
Icarus|Icarus|||
Identikit|Identikit|||
Imogen|Imogen|||
Impact!|Impact!|||
Impossible Mission|Impossible Mission|||
Indoor Soccer|Indoor Soccer|||
Indoor Sports|Indoor Sports|||
Inertia|Inertia|||
Infinity|Infinity|||
Ingrid's Back!|Ingrid's Back!|||
Inheritance|Inheritance|||
Inner Space|Inner Space|||
In Search of Atahaulpa|In Search of Atahaulpa|||
International Megasports|International Megasports|||
Into the Unknown|Into the Unknown|||
Inu|Inu|||
Island Adventure|Island Adventure|||
Islandia|Islandia|||
Island of Xaan|Island of Xaan|||
It's Magic|It's Magic|||
Jack and the Beanstalk|Jack and the Beanstalk|||
Jack Attack|Jack Attack|||
James Bond 007: The Living Daylights|James Bond 007 - The Living Daylights|||
JBiPlane|JBiPlane|||
JCB Digger|JCB Digger|||
Jeremy Goes Jumping|Jeremy Goes Jumping|||
Jet Boat|Jet Boat|||
Jet Boot Jack|Jet Boot Jack|||
Jet-Pac|Jet-Pac|||
Jet Power Jack|Jet Power Jack|||
Jet Set Miner|Jet Set Miner|||
Jetset Willy II|Jetset Willy II|||
Jetset Willy|Jetset Willy|||
Jigsaw|Jigsaw|||
Joe Blade 2|Joe Blade 2|||
Joe Blade|Joe Blade|||
Joey|Joey|||
Johnny Reb|Johnny Reb|||
Jouster|Jouster|||
J.R.|J.R.|||
JSnake|JSnake|||
Juggle Puzzle|Juggle Puzzle|||
Jumbo|Jumbo|||
Jump Jet|Jump Jet|||
Jungle Jive|Jungle Jive|||
Junior Maths Pack|Junior Maths Pack|||
Junior Maths Part 1|Junior Maths Part 1|||
Junior Maths Part 2|Junior Maths Part 2|||
Kamikaze|Kamikaze|||
Kane|Kane|||
Karate Combat|Karate Combat|||
Karl's Cavern|Karl's Cavern|||
Katakombs|Katakombs|||
Kensington|Kensington|||
Killapede|Killapede|||
Killer Gorilla 2|Killer Gorilla 2|||
Killer Gorilla: Killa the Upgrade|Killer Gorilla - Killa the Upgrade|||
Killer Gorilla|Killer Gorilla|||
Kingdom of Hamil|Kingdom of Hamil|||
Kingdom of Klein, The: Epic Adventure 3|Kingdom of Klein, The - Epic Adventure 3|||
King of the Castle|King of the Castle|||
Kings Cross Traffic Control|Kings Cross Traffic Control|||
Kissin' Kousins|Kissin' Kousins|||
KIX|KIX|||
Klax|Klax|||
Knight Lore|Knight Lore|||
Kourtyard|Kourtyard|||
Krakout!|Krakout!|||
Krazy John|Krazy John|||
Labyrinth|Labyrinth|||
Labyrinths of LaCoshe|Labyrinths of LaCoshe|||
Ladder Maze|Ladder Maze|||
Lancelot|Lancelot|||
Landfall|Landfall|||
Land of Tezrel|Land of Tezrel|||
Laser Command|Laser Command|||
Laser Letters|Laser Letters|||
Laser Reflex|Laser Reflex|||
Last Days of Doom|Last Days of Doom|||
Last of the Free|Last of the Free|||
Las Vegas|Las Vegas|||
LazerChess|LazerChess|||
Lazer Cycle|Lazer Cycle|||
League Challege|League Challege|||
Leap Frog|Leap Frog|||
Ledgeman|Ledgeman|||
Legion Adventure|Legion Adventure|||
Lemming Syndrome|Lemming Syndrome|||
Lester Leaps In|Lester Leaps In|||
Liberator|Liberator|||
License to Kill|License to Kill|||
Lickey Route|Lickey Route|||
Light Cycle|Light Cycle|||
Light Cycles|Light Cycles|||
Lime Street Traffic Control|Lime Street Traffic Control|||
Little Red Riding Hood|Little Red Riding Hood|||
Locks of Luck|Locks of Luck|||
Loco Motion!|Loco Motion!|||
Loderunner|Loderunner|||
Lollipops|Lollipops|||
Look and Read: Geordie Racer|Look and Read - Geordie Racer|||
Looney Lift|Looney Lift|||
Looney Loco|Looney Loco|||
Loopz|Loopz|||
Lord of the Rings|Lord of the Rings|||
Lords of Time|Lords of Time|||
Lost City|Lost City|||
Lost Crystal, The: Epic Adventure 5|Lost Crystal, The - Epic Adventure 5|||
Lost in Space|Lost in Space|||
Ludo|Ludo|||
Lunar Jetman|Lunar Jetman|||
Lunar Lander|Lunar Lander|||
Lunar Rescue|Lunar Rescue|||
Mad Monty|Mad Monty|||
Magic Adventure #1|Magic Adventure #1|||
Magic Eel|Magic Eel|||
Magic Mushrooms|Magic Mushrooms|||
Magnetic Moon|Magnetic Moon|||
Main-Line|Main-Line|||
Mallory Manor|Mallory Manor|||
Manage|Manage|||
Mango|Mango|||
Maniac|Maniac|||
Manic Miner|Manic Miner|||
Manic Mole|Manic Mole|||
Map Rally|Map Rally|||
Martian Attack|Martian Attack|||
Martians|Martians|||
Masterbrain|Masterbrain|||
Master Break|Master Break|||
Master Cutler|Master Cutler|||
Mastermind|Mastermind|||
Mastermind Quizmaster|Mastermind Quizmaster|||
Masters of the Universe|Masters of the Universe|||
MasterSpy|MasterSpy|||
Match Day|Match Day|||
Maths Invaders|Maths Invaders|||
Mayday|Mayday|||
Maze in Space, A|Maze in Space, A|||
Maze Invaders|Maze Invaders|||
Maze Man|Maze Man|||
Maze|Maze|||
MazezaM|MazezaM|||
Mega Apocalypse|Mega Apocalypse|||
Mega Force|Mega Force|||
Mega Rok|Mega Rok|||
Mendips Stone|Mendips Stone|||
Merry Xmas Santa|Merry Xmas Santa|||
Meteor Mission|Meteor Mission|||
Meteors|Meteors|||
Mexico 86|Mexico 86|||
Microball|Microball|||
Microbe|Microbe|||
Microcosm|Microcosm|||
Micro Derby|Micro Derby|||
Micro Olympics|Micro Olympics|||
MicroQuest|MicroQuest|||
Midway|Midway|||
Mikie|Mikie|||
Millepede|Millepede|||
Millionaire|Millionaire|||
MindBender|MindBender|||
Mined Out|Mined Out|||
Minefield|Minefield|||
Mineshaft|Mineshaft|||
Mirror of Khoronz|Mirror of Khoronz|||
Missile Attack|Missile Attack|||
Missile Base|Missile Base|||
Missile Control|Missile Control|||
Missile Jammer|Missile Jammer|||
Missile Strike|Missile Strike|||
Mission|Mission|||
Mission: XP2|Mission - XP2|||
Mister Freeze|Mister Freeze|||
Mixed Grill March|Mixed Grill March|||
Model A Invaders|Model A Invaders|||
Model B Invaders|Model B Invaders|||
Mole|Mole|||
Mole!|Mole!|||
Monaco|Monaco|||
Money Maze|Money Maze|||
Monkeynuts|Monkeynuts|||
Monopoly|Monopoly|||
Monster Mash|Monster Mash|||
Monster Maze|Monster Maze|||
Monsters and Magic|Monsters and Magic|||
Monsters|Monsters|||
Moonbase Alpha|Moonbase Alpha|||
Moonbase Beta|Moonbase Beta|||
Moon Buggy|Moon Buggy|||
Moon Cresta|Moon Cresta|||
Moon Mission|Moon Mission|||
Moon Raider|Moon Raider|||
Morfix|Morfix|||
Morris Miner|Morris Miner|||
Mount the Mountain|Mount the Mountain|||
Mouse Trap|Mouse Trap|||
Mr. Do|Mr. Do|||
Mr. Ee!|Mr. Ee!|||
Mr. Men: First Steps|Mr. Men - First Steps|||
Mr. Men: Mr. Noisy & Mr. Bounce|Mr. Men - Mr. Noisy & Mr. Bounce|||
Mr. Mephisto|Mr. Mephisto|||
Mr. Shifter|Mr. Shifter|||
Mr. Wimpy|Mr. Wimpy|||
Mr. Wiz|Mr. Wiz|||
Munchyman|Munchyman|||
Murdac|Murdac|||
Murder at the Abbey|Murder at the Abbey|||
Mutant Breakout|Mutant Breakout|||
Mutant Spiders|Mutant Spiders|||
Myorem: The Final Part of the Rick Hanson Trilogy|Myorem - The Final Part of the Rick Hanson Trilogy|||
Mysterious Adventure 01: Golden Baton|Mysterious Adventure 01 - Golden Baton|||
Mysterious Adventure 02: Time Machine|Mysterious Adventure 02 - Time Machine|||
Mysterious Adventure 03: Arrow of Death: Part 1|Mysterious Adventure 03 - Arrow of Death - Part 1|||
Mysterious Adventure 04: Arrow of Death: Part 2|Mysterious Adventure 04 - Arrow of Death - Part 2|||
Mysterious Adventure 05: Escape from Pulsar 7|Mysterious Adventure 05 - Escape from Pulsar 7|||
Mysterious Adventure 06: Circus|Mysterious Adventure 06 - Circus|||
Mysterious Adventure 07: Feasibility Experiment|Mysterious Adventure 07 - Feasibility Experiment|||
Mysterious Adventure 08: Wizard of Akyrz|Mysterious Adventure 08 - Wizard of Akyrz|||
Mysterious Adventure 09: Perseus and Andromeda|Mysterious Adventure 09 - Perseus and Andromeda|||
Mysterious Adventure 10: Ten Little Indians|Mysterious Adventure 10 - Ten Little Indians|||
Mysterious Adventure 11: Waxworks|Mysterious Adventure 11 - Waxworks|||
Mystery of the Java Star|Mystery of the Java Star|||
Name|HyperList|NoIntro|TOSEC|ReDump
Neanderthal Man|Neanderthal Man|||
Nebulon Attack|Nebulon Attack|||
Nemesis|Nemesis|||
Neutron|Neutron|||
Neuzone|Neuzone|||
Nevryon|Nevryon|||
Nifty Lifty|Nifty Lifty|||
Night Flite|Night Flite|||
Nightmare Maze|Nightmare Maze|||
Nightshade|Nightshade|||
Night Strike|Night Strike|||
Night World|Night World|||
Noc a Bloc|Noc a Bloc|||
Norman England|Norman England|||
Not a Penny More, Not a Penny Less|Not a Penny More, Not a Penny Less|||
Number Chaser|Number Chaser|||
Number Gulper|Number Gulper|||
Number Painter|Number Painter|||
Number Puzzler|Number Puzzler|||
Numeracy 2|Numeracy 2|||
Nutcracka|Nutcracka|||
Nutter|Nutter|||
Nyan SID|Nyan SID|||
Oblivion|Oblivion|||
OddJob|OddJob|||
Ogles|Ogles|||
Old Father Time|Old Father Time|||
Old MacDonald|Old MacDonald|||
Olympic Decathlon|Olympic Decathlon|||
Omega|Omega|||
Omega Orb|Omega Orb|||
Omega Probe|Omega Probe|||
One Last Game|One Last Game|||
One to Nine|One to Nine|||
Operation Safras|Operation Safras|||
Orbital|Orbital|||
Orbit Zero|Orbit Zero|||
Orcrest|Orcrest|||
Orpheus and the Underword|Orpheus and the Underword|||
Osprey!|Osprey!|||
Ossie|Ossie|||
Othello|Othello|||
Overdrive|Overdrive|||
Owzat|Owzat|||
Oxbridge|Oxbridge|||
Pacman|Pacman|||
Paddington Control|Paddington Control|||
Pad Switch Games|Pad Switch Games|||
Paintbox|Paintbox|||
Painter|Painter|||
Palace of Magic|Palace of Magic|||
Pandemonium|Pandemonium|||
Panik|Panik|||
Pantheon|Pantheon|||
Pantry Antics|Pantry Antics|||
Paperboy|Paperboy|||
Parachute|Parachute|||
Paradox|Paradox|||
Paranoid Pete|Paranoid Pete|||
Paras|Paras|||
Pass Go: Property Game|Pass Go - Property Game|||
Passport to Death|Passport to Death|||
Patience|Patience|||
Paul Daniels' Magic Show|Paul Daniels' Magic Show|||
Peak Fleet Manager|Peak Fleet Manager|||
Pearl Harbour|Pearl Harbour|||
Pear Picker|Pear Picker|||
Pedro|Pedro|||
Peeko-Computer|Peeko-Computer|||
Pengi|Pengi|||
Pengo|Pengo|||
Pengwyn|Pengwyn|||
Pentominoes|Pentominoes|||
Penzance Traffic Control|Penzance Traffic Control|||
Percy Penguin|Percy Penguin|||
Perplexity|Perplexity|||
Personal Quiz|Personal Quiz|||
Pettigrew's Diary|Pettigrew's Diary|||
Phantom|Phantom|||
Pharoah's Tomb|Pharoah's Tomb|||
Philosopher's Quest|Philosopher's Quest|||
Pilgrim's Progress|Pilgrim's Progress|||
Pimania|PiMania|||
Pinball Arcade|Pinball Arcade|||
Pinball|Pinball|||
Pipeline|Pipeline|||
Pipe Mania|Pipe Mania|||
Pirates in Space|Pirates in Space|||
Pirate's Peril|Pirate's Peril|||
Pirates|Pirates|||
Plague Planet|Plague Planet|||
Plan B: Part 2: Mission Unlikely|Plan B - Part 2 - Mission Unlikely|||
Plan B|Plan B|||
Plane Crash|Plane Crash|||
Planes|Planes|||
Planetfall|Planetfall|||
Planet of the Aliens|Planet of the Aliens|||
Planetoid|Planetoid|||
Plank Walk|Plank Walk|||
Playbox|Playbox|||
Plegaron People Eaters|Plegaron People Eaters|||
Plunder|Plunder|||
Plutonium Plunder|Plutonium Plunder|||
Podd|Podd|||
Pod Man Joe|Pod Man Joe|||
Pogo Pete|Pogo Pete|||
Poker Dice|Poker Dice|||
Poker|Poker|||
Polaris|Polaris|||
Polar Perils|Polar Perils|||
Pole Position|Pole Position|||
Pontoon|Pontoon|||
Pony Express|Pony Express|||
Pool Hall|Pool Hall|||
PooperPig|PooperPig|||
Pop Quiz Master|Pop Quiz Master|||
Positron|Positron|||
Power Bandit|Power Bandit|||
Powerboat Racing|Powerboat Racing|||
Powerplay: The Game of the Gods|Powerplay - The Game of the Gods|||
Predator|Predator|||
Prison|Prison|||
Pro Boxing Simulator|Pro Boxing Simulator|||
Pro-Golf|Pro-Golf|||
ProGolf|ProGolf|||
Programmer's Revenge|Programmer's Revenge|||
Project Thesius: Rick Hanson Part 2|Project Thesius - Rick Hanson Part 2|||
Prophecy, The: Rising of Salandra, The: Part 1|Prophecy, The - Rising of Salandra, The - Part 1|||
Proteans|Proteans|||
Protector|Protector|||
Psycastria 2|Psycastria 2|||
Psycastria|Psycastria|||
Puc-Man|Puc-Man|||
Puncman 1 and 2|Puncman 1 and 2|||
Puppet Man, The: Adventure 5|Puppet Man, The - Adventure 5|||
Purple People Eaters|Purple People Eaters|||
Pyramid Painter|Pyramid Painter|||
Q-Bert|Q-Bert|||
Q-Bix|Q-Bix|||
Q-Boyd|Q-Boyd|||
Q-Man's Brother|Q-Man's Brother|||
Q-Master|Q-Master|||
Quadline|Quadline|||
Quasimodo|Quasimodo|||
Quest for Freedom|Quest for Freedom|||
Question of Sport, A|Question of Sport, A|||
Quest Probe 1: Incredible Hulk|Quest Probe 1 - Incredible Hulk|||
Quest Probe 2: Spiderman|Quest Probe 2 - Spiderman|||
Quest Probe 3: Fantastic Four|Quest Probe 3 - Fantastic Four|||
Quest|Quest|||
Quondam|Quondam|||
Qwak!|Qwak!|||
Racer|Racer|||
Raid Over Moscow|Raid Over Moscow|||
Ransack!|Ransack!|||
Ravage|Ravage|||
Ravenskull|Ravenskull|||
Rebel Planet|Rebel Planet|||
Redcoats|Redcoats|||
Red Moon|Red Moon|||
Reluctant Hero|Reluctant Hero|||
Renegade Robots|Renegade Robots|||
Repton 2|Repton 2|||
Repton 3: Around the World in 40 Screens|Repton 3 - Around the World in 40 Screens|||
Repton 3|Repton 3|||
Repton 3: Repton Thru Time|Repton 3 - Repton Thru Time|||
Repton 3: The Life of Repton|Repton 3 - The Life of Repton|||
Repton Infinity|Repton Infinity|||
Repton|Repton|||
Return of Flint|Return of Flint|||
Return of R2|Return of R2|||
Return to Doom|Return to Doom|||
Return to Eden|Return to Eden|||
Revenge of the Snowmen|Revenge of the Snowmen|||
Revenge of Zor|Revenge of Zor|||
Reversi|Reversi|||
Revs 4 Tracks|Revs 4 Tracks|||
Revs: 5 Tracks|Revs - 5 Tracks|||
Revs|Revs|||
Rick Hanson|Rick Hanson|||
Ricochet|Ricochet|||
Rig Attack|Rig Attack|||
Rik the Roadie|Rik the Roadie|||
Ripton|Ripton|||
Roadcraft 1|Roadcraft 1|||
Road Runner|Road Runner|||
Robin of Sherwood|Robin of Sherwood|||
Robobrain|Robobrain|||
Roboman|Roboman|||
Roboto|Roboto|||
Robotron 2084|Robotron 2084|||
Robotron|Robotron|||
Rocket Raid|Rocket Raid|||
Rock Fall|Rock Fall|||
Rocky|Rocky|||
Rohak the Swordsman|Rohak the Swordsman|||
Roman Empire|Roman Empire|||
Rondaxians|Rondaxians|||
Roulette|Roulette|||
Roundheads and Cavaliers|Roundheads and Cavaliers|||
Row of Four|Row of Four|||
Royal Scot|Royal Scot|||
R-Ther|R-Ther|||
Rubble Trouble|Rubble Trouble|||
Rubik Cube|Rubik Cube|||
Runemagic: Secret River & Wizard's Citadel|Runemagic - Secret River & Wizard's Citadel|||
Runemaker: Codename Druid|Runemaker - Codename Druid|||
Runesmith|Runesmith|||
Runestaff|Runestaff|||
Run Silent, Run Deep|Run Silent, Run Deep|||
Sabre Wulf: Extended Version|Sabre Wulf - Extended Version|||
Sabre Wulf|Sabre Wulf|||
Sadim Castle|Sadim Castle|||
Saigon|Saigon|||
Saloon Sally|Saloon Sally|||
Samantha Fox Strip Poker|Samantha Fox Strip Poker|||
Santa's Delivery|Santa's Delivery|||
SAS Commander|SAS Commander|||
Savage Pond|Savage Pond|||
Scan|Scan|||
Scapeghost|Scapeghost|||
Science Fiction Quiz|Science Fiction Quiz|||
Scoop|Scoop|||
Scorpion Patience|Scorpion Patience|||
Scot Rail Express|Scot Rail Express|||
Scrabble|Scrabble|||
Scramble|Scramble|||
Screwball|Screwball|||
Sea Adventure|Sea Adventure|||
Sea Lord|Sea Lord|||
Sea Wolf|Sea Wolf|||
Secret Sam: Adventure 1|Secret Sam - Adventure 1|||
Secret Sam: Adventure 2|Secret Sam - Adventure 2|||
Secta Invaders|Secta Invaders|||
Sentinel|Sentinel|||
Shadowfax|Shadowfax|||
Shanghai Warriors|Shanghai Warriors|||
Shape Match|Shape Match|||
Shark Attack|Shark Attack|||
Shark|Shark|||
Shove It!|Shove It!|||
Shuttle|Shuttle|||
Shuttle Simulator|Shuttle Simulator|||
Side Fighter|Side Fighter|||
Siege|Siege|||
Sim City|Sim City|||
Simon|Simon|||
Sim|Sim|||
Sinbad|Sinbad|||
Sink the Bismarck|Sink the Bismarck|||
Skirmish|Skirmish|||
Ski Slalom|Ski Slalom|||
Skyhawk|Skyhawk|||
Sleigh Bells|Sleigh Bells|||
Slicker|Slicker|||
Sliding Block Puzzles|Sliding Block Puzzles|||
Sliding Puzzles|Sliding Puzzles|||
Smash 7|Smash 7|||
Smash and Grab|Smash and Grab|||
Snacker|Snacker|||
Snail Trail|Snail Trail|||
Snake-Pit|Snake-Pit|||
Snaker|Snaker|||
Snakes and Ladders|Snakes and Ladders|||
Snake|Snake|||
Snapper|Snapper|||
Snooker|Snooker|||
Snorter|Snorter|||
Snowball|Snowball|||
Soccer Boss|Soccer Boss|||
Soccer Manager|Soccer Manager|||
Soccer Supremo|Soccer Supremo|||
Soccer Supremo!|Soccer Supremo!|||
Solitaire|Solitaire|||
Son of Blagger|Son of Blagger|||
Sorcery|Sorcery|||
S.O.R.T.|S.O.R.T.|||
South Devon Hydraulics|South Devon Hydraulics|||
Southern Belle|Southern Belle|||
Space Adventure 1|Space Adventure 1|||
Space Adventure|Space Adventure|||
Space Caverns|Space Caverns|||
Space Fighter|Space Fighter|||
Spaceguard|Spaceguard|||
Space Hawk|Space Hawk|||
Space Hawks|Space Hawks|||
Space Hi-Way|Space Hi-Way|||
Space Intruders|Space Intruders|||
Space Invaders|Space Invaders|||
Space Jailer|Space Jailer|||
Space Kingdom|Space Kingdom|||
Spaceman Sid|Spaceman Sid|||
Space Maze|Space Maze|||
Space Pilot|Space Pilot|||
Space Pirates|Space Pirates|||
Space Ranger|Space Ranger|||
Space Rescue|Space Rescue|||
Space Shuttle Pilot|Space Shuttle Pilot|||
Space Station Alpha|Space Station Alpha|||
Space Warp|Space Warp|||
Spanish Gold|Spanish Gold|||
Sparse Invaders|Sparse Invaders|||
Special Operations|Special Operations|||
Spectapede|Spectapede|||
Spellbinder|Spellbinder|||
Sphenisciformes|Sphenisciformes|||
Sphere of Destiny 2|Sphere of Destiny 2|||
Sphere of Destiny|Sphere of Destiny|||
Spheroids|Spheroids|||
Sphinx Adventure|Sphinx Adventure|||
Spitfire 40|Spitfire 40|||
Spitfire Command|Spitfire Command|||
Spitfire Flight Simulator|Spitfire Flight Simulator|||
Spooks and Spiders|Spooks and Spiders|||
Spooksville|Spooksville|||
Spooky Manor|Spooky Manor|||
Sporting Triangles|Sporting Triangles|||
Sport Spectacular|Sport Spectacular|||
SpyCat|SpyCat|||
Spy Hunter|Spy Hunter|||
Spy vs Spy|Spy vs Spy|||
Squeekaliser|Squeekaliser|||
Squeeze|Squeeze|||
Staircase Stampede!|Staircase Stampede!|||
Stairway to Hell|Stairway to Hell|||
Star Battle!|Star Battle!|||
Star Clash|Star Clash|||
Star Drifter|Star Drifter|||
Starfire|Starfire|||
Starfleet Encounter|Starfleet Encounter|||
Starforce Lander|Starforce Lander|||
Star Force Seven|Star Force Seven|||
Star Maze II|Star Maze II|||
Star Maze|Star Maze|||
Star Port|Star Port|||
Starquake|||Star Quake|
Star Quake|Star Quake|||
Starship Command|Starship Command|||
Starship Discovery|Starship Discovery|||
Starship Quest|Starship Quest|||
Star Soccer|Star Soccer|||
Star Striker|Star Striker|||
Star Swarm|Star Swarm|||
Star Trader|Star Trader|||
Star Trek Adventure|Star Trek Adventure|||
Star Trek|Star Trek|||
Star Trek the Game|Star Trek the Game|||
Star Warp|Star Warp|||
Star Wars: Return of the Jedi|Star Wars - Return of the Jedi|||
Star Wars|Star Wars|||
Star Wars: The Empire Strikes Back|Star Wars - The Empire Strikes Back|||
Statix|Statix|||
Steve Davis Snooker|Steve Davis Snooker|||
Sticky Fingers!|Sticky Fingers!|||
Stix|Stix|||
Stock Car|Stock Car|||
Stock Market|Stock Market|||
Stormcycle|Stormcycle|||
Stranded On Iloofrax|Stranded On Iloofrax|||
Stranded|Stranded|||
Stranded!|Stranded!|||
Strategy II: Hunt for the Bismark|Strategy II - Hunt for the Bismark|||
Strategy I: Invasion|Strategy I - Invasion|||
Stratobomber|Stratobomber|||
Strawberry Fields|Strawberry Fields|||
Street Machine|Street Machine|||
Street Patroller Remix|Street Patroller Remix|||
Street Patroller|Street Patroller|||
Strike Force Harrier|Strike Force Harrier|||
Strip Poker II Plus|Strip Poker II Plus|||
Strip Poker|Strip Poker|||
Stryker's Run|Stryker's Run|||
SubKiller|SubKiller|||
Sub-Strike|Sub-Strike|||
Subway Vigilante|Subway Vigilante|||
Suds|Suds|||
Suicide Island|Suicide Island|||
Summer Olympiad|Summer Olympiad|||
Super Agent Flint III: Flint Strikes Back|Super Agent Flint III - Flint Strikes Back|||
Super Agent Flint II|Super Agent Flint II|||
Super Agent Flint|Super Agent Flint|||
Super Barricade|Super Barricade|||
Super Defender|Super Defender|||
Super Fruit|Super Fruit|||
Super Golf|Super Golf|||
Super Gran: The Adventure|Super Gran - The Adventure|||
Super Hangman|Super Hangman|||
Super Invaders|Super Invaders|||
Superior Soccer|Superior Soccer|||
SuperLife|SuperLife|||
Superman: Man of Steel|Superman - Man of Steel|||
Superman: The Game|Superman - The Game|||
Super Pool|Super Pool|||
Super Spy Flint|Super Spy Flint|||
Survivor|Survivor|||
Swag!|Swag!|||
Swamp Monsters|Swamp Monsters|||
Swarmer|Swarmer|||
Swarm|Swarm|||
Swoop|Swoop|||
Swordmaster|Swordmaster|||
Swords and Sorcery|Swords and Sorcery|||
Syncron|Syncron|||
System 15000|System 15000|||
System 8|System 8|||
Table Adventures|Table Adventures|||
Tactic|Tactic|||
Tales of the Arabian Nights|Tales of the Arabian Nights|||
Tank Attack|Tank Attack|||
Tanks|Tanks|||
Tanks!|Tanks!|||
Tapper|Tapper|||
Taroda Scheme|Taroda Scheme|||
Tarzan|Tarzan|||
Task-Force|Task-Force|||
Tees-Tyne Pullman|Tees-Tyne Pullman|||
Tempest|Tempest|||
Temple of Terror|Temple of Terror|||
Templeton|Templeton|||
Tennis|Tennis|||
Terromolinos!|Terromolinos!|||
Test Match Cricket|Test Match Cricket|||
Tetrapod|Tetrapod|||
Tetris|Tetris|||
Thames Local|Thames Local|||
The Abominable Snowmen|Abominable Snowmen, The|||
The Adventure #12: Golden Voyage|Adventure #12 - Golden Voyage, The|||
The Adventure #13: Sorceror of Claymorgue Castle|Adventure #13 - Sorceror of Claymorgue Castle, The|||
The Adventures of Gnasher|Adventures of Gnasher, The|||
The Amazing Q-Man|Amazing Q-Man, The|||
The Arcade Adventure Design Kit|Arcade Adventure Design Kit, The|||
The Archers|Archers, The|||
The Avaunting|Avaunting, The|||
The Best Four|Best Four, The|||
The Big KO|Big KO, The|||
The Box of Treasures|Box of Treasures, The|||
The Curse of the Middle Kingdom|Curse of the Middle Kingdom, The|||
The Dam Busters|Dam Busters, The|||
The Devil's Domain|Devil's Domain, The|||
The Druid's Circle|Druid's Circle, The|||
The Evil Dead|Evil Dead, The|||
The Eye of Zolton|Eye of Zolton, The|||
The Fall of Rome|Fall of Rome, The|||
The Ferryman Awaits|Ferryman Awaits, The|||
The Five Doctors|Five Doctors, The|||
The Five|Five, The|||
The Five Spheres|Five Spheres, The|||
The Five Stones of Anadon|Five Stones of Anadon, The|||
The Flight of the Unicorn|Flight of the Unicorn, The|||
The Frog|Frog, The|||
The Garden|Garden, The|||
The Genesis Project|Genesis Project, The|||
The Golden Figurine|Golden Figurine, The|||
The Great Wall|Great Wall, The|||
The Growing Pains of Adrian Mole|Growing Pains of Adrian Mole, The|||
The Guns of Navarone|Guns of Navarone, The|||
The Guy in the Hat|Guy in the Hat, The|||
The Hacker|Hacker, The|||
The Haunted Abbey|Haunted Abbey, The|||
The Hobbit|Hobbit, The|||
The Horse Lord|Horse Lord, The|||
The Hunt|Hunt, The|||
The Inter City|Inter City, The|||
The Intergalactic Trading Game|Intergalactic Trading Game, The|||
The Ket Trilogy|Ket Trilogy, The|||
The Killing of Kayleth|Killing of Kayleth, The|||
The Kremlin|Kremlin, The|||
The Last Ninja 2|Last Ninja 2, The|||
The Last Ninja|Last Ninja, The|||
The Mad Bomber|Mad Bomber, The|||
The Mad Painter|Mad Painter, The|||
The Magic Sword|Magic Sword, The|||
The Maze|Maze, The|||
The Mid-Day Scot|Mid-Day Scot, The|||
The Mine|Mine, The|||
The Mystery of the Lost Sheep|Mystery of the Lost Sheep, The|||
The Network|Network, The|||
The Nine Dancers|Nine Dancers, The|||
The Pen and the Dark|Pen and the Dark, The|||
The Perils of Percival Penguin|Perils of Percival Penguin, The|||
The Philosopher's Stone|Philosopher's Stone, The|||
The Pines Express|Pines Express, The|||
The Price of Magik|Price of Magik, The|||
The Pyramid|Pyramid, The|||
The Quest for the Holy Grail|Quest for the Holy Grail, The|||
The Quest|Quest, The|||
The Quill|Quill, The|||
The Real You|Real You, The|||
The Red Arrows|Red Arrows, The|||
The Rick Hanson Trilogy|Rick Hanson Trilogy, The|||
The Ring of Time|Ring of Time, The|||
The Rising of Salandra Part 2: Return of the Warrior|Rising of Salandra Part 2 - Return of the Warrior, The|||
The Saga of Erik the Viking|Saga of Erik the Viking, The|||
The Secret Diary of Adrian Mole|Secret Diary of Adrian Mole, The|||
The Sentinel|Sentinel, The|||
The Seventh Star|Seventh Star, The|||
The Shapes Game|Shapes Game, The|||
The Shrinking Professor's Quest|Shrinking Professor's Quest, The|||
The Sorcerer's Kingdom|Sorcerer's Kingdom, The|||
The Sorcerer|Sorcerer, The|||
The Staff of Law|Staff of Law, The|||
The Sting|Sting, The|||
The Stolen Lamp|Stolen Lamp, The|||
The Super Green Gloop Gulper Game|Super Green Gloop Gulper Game, The|||
The Survivors|Survivors, The|||
The Three Crystals|Three Crystals, The|||
The Tipster|Tipster, The|||
The Tombs of Tutankhamen|Tombs of Tutankhamen, The|||
The TransylvanianTerror|TransylvanianTerror, The|||
The Valley|Valley, The|||
The Warlord|Warlord, The|||
The Way of the Exploding Fist V2|Way of the Exploding Fist V2, The|||
The Way of the Exploding Fist|Way of the Exploding Fist, The|||
The Weetabix Versus the Titchies|Weetabix Versus the Titchies, The|||
The Wheel of Fortune|Wheel of Fortune, The|||
The White Barrows|White Barrows, The|||
The Wizard's Return|Wizard's Return, The|||
The Wizard's Revenge|Wizard's Revenge, The|||
The Wizard|Wizard, The|||
The World Travel Game|World Travel Game, The|||
Through the Dragon's Eye|Through the Dragon's Eye|||
Thrust|Thrust|||
Thunderball|Thunderball|||
Thunder Struck II|Thunder Struck II|||
Thunder Struck!|Thunder Struck!|||
Tidbits Teaser|Tidbits Teaser|||
Time Adventure|Time Adventure|||
Time and Magik|Time and Magik|||
Timelapsed|Timelapsed|||
Time Lords|Time Lords|||
Times Computer Crosswords, The: Vol. 1|Times Computer Crosswords, The - Vol. 1|||
TimeSlip|TimeSlip|||
Time Traveller|Time Traveller|||
Timetrek: Starship Enterprise|Timetrek - Starship Enterprise|||
Tomahawk|Tomahawk|||
Tomb of Death|Tomb of Death|||
Tower Bridge|Tower Bridge|||
Tower of Alos|Tower of Alos|||
Tower of Hanoi|Tower of Hanoi|||
Toyshop|Toyshop|||
Traditional Games|Traditional Games|||
Trafalgar|Trafalgar|||
Transistor's Revenge|Transistor's Revenge|||
Trapper|Trapper|||
Treasure Hunt|Treasure Hunt|||
Tree of Knowledge|Tree of Knowledge|||
Trek II|Trek II|||
Trek|Trek|||
Trench|Trench|||
Triple Decker 10|Triple Decker 10|||
Triple Decker 1|Triple Decker 1|||
Triple Decker 2|Triple Decker 2|||
Triple Decker 3|Triple Decker 3|||
Triple Decker 4|Triple Decker 4|||
Triple Decker 5|Triple Decker 5|||
Triple Decker 6|Triple Decker 6|||
Triple Decker 7|Triple Decker 7|||
Triple Decker 9|Triple Decker 9|||
Trivial Pursuit: BBC Genus Edition|Trivial Pursuit - BBC Genus Edition|||
Tunnel Adventure|Tunnel Adventure|||
Turbo|Turbo|||
Turf Form|Turf Form|||
Tutankhamun's Revenge|Tutankhamun's Revenge|||
Twelfth Night|Twelfth Night|||
Twin Kingdom Valley|Twin Kingdom Valley|||
Twin Orbs of Aalinor|Twin Orbs of Aalinor|||
Two Adventures: Volcano & Dracula|Two Adventures - Volcano & Dracula|||
Uggies Garden|Uggies Garden|||
Ultimate Prize|Ultimate Prize|||
Ultra Intelligent Machine|Ultra Intelligent Machine|||
Ultron|Ultron|||
Uncle Claude|Uncle Claude|||
Underground Adventure|Underground Adventure|||
Uranians|Uranians|||
Uridium|Uridium|||
US Drag Racing|US Drag Racing|||
Valley of the Kings|Valley of the Kings|||
Valley of the Pharaohs|Valley of the Pharaohs|||
Vampire Castle|Vampire Castle|||
Vegas Jackpot|Vegas Jackpot|||
Vertigo|Vertigo|||
Video Card Arcade|Video Card Arcade|||
Video Classics|Video Classics|||
Video Pinball|Video Pinball|||
Video's Revenge|Video's Revenge|||
Village of Lost Souls|Village of Lost Souls|||
Vindaloo|Vindaloo|||
Volcano|Volcano|||
Vortex|Vortex|||
VTOL|VTOL|||
Wallaby|Wallaby|||
Wall|Wall|||
Wally Goes Walkies|Wally Goes Walkies|||
Warehouse|Warehouse|||
War Games|War Games|||
Warlord of Doom|Warlord of Doom|||
Warp-1|Warp-1|||
War|War|||
Waterloo|Waterloo|||
Web Runner|Web Runner|||
Web War|Web War|||
Wendy Goes Walkies|Wendy Goes Walkies|||
WestQuest 1847|WestQuest 1847|||
West|West|||
What's Eeyore's|What's Eeyore's|||
Wheeler Dealer|Wheeler Dealer|||
Where!|Where!|||
White Knight: MK11|White Knight - MK11|||
White Knight: MK12|White Knight - MK12|||
White Magic 2|White Magic 2|||
White Magic|White Magic|||
Who Dares Wins 2|Who Dares Wins 2|||
Whoopsy|Whoopsy|||
Wiggles|Wiggles|||
William the Conqueror|William the Conqueror|||
Winged Warlords|Winged Warlords|||
Winter Olympiad '88|Winter Olympiad '88|||
Winter Olympics|Winter Olympics|||
Winter Wonderland|Winter Wonderland|||
Wizadore|Wizadore|||
Wizard's Challenge|Wizard's Challenge|||
Wizzy's Mansion|Wizzy's Mansion|||
Woks!!|Woks!!|||
Wolfpack III|Wolfpack III|||
Wonder Worm|Wonder Worm|||
Wongo!|Wongo!|||
Woodbury End|Woodbury End|||
Woodland Terror|Woodland Terror|||
Wordhang|Wordhang|||
WordPower|WordPower|||
Wordsearch|Wordsearch|||
Wordsquare, Seabattle, Pick-a-Pair|Wordsquare, Seabattle, Pick-a-Pair|||
Words Words Words|Words Words Words|||
World Cup Manager|World Cup Manager|||
World Geography|World Geography|||
World War I|World War I|||
World-Wise|World-Wise|||
Worm in Paradise|Worm in Paradise|||
Wormy Num Num|Wormy Num Num|||
Wychwood|Wychwood|||
Xadomy|Xadomy|||
Xanadu Adventure|Xanadu Adventure|||
Xanadu Cottage|Xanadu Cottage|||
Xanagrams|Xanagrams|||
Xenapor|Xenapor|||
XLCR: Squiggly Snake II|XLCR - Squiggly Snake II|||
Xor|XOR|||
Yes Prime Minster|Yes Prime Minster|||
Yie Ar Kung Fu II|Yie Ar Kung Fu II|||
Yie Ar Kung Fu|Yie Ar Kung Fu|||
Yoyo|Yoyo|||
Zalaga|Zalaga|||
Zany Kong Junior|Zany Kong Junior|||
Zany Kong|Zany Kong|||
Zarm|Zarm|||
Zelda Meets the Bug-Eyes|Zelda Meets the Bug-Eyes|||
Zenon|Zenon|||
Ziggy|Ziggy|||
Zombie Island|Zombie Island|||
Zombies|Zombies|||
Zorakk the Conqueror|Zorakk the Conqueror|||
